lib_epci,hommes_moins_de_25_ans,hommes_25_a_49_ans,hommes_plus_de_50_ans,total_hommes,femmes_moins_de_25_ans,femmes_25_a_49_ans,femmes_plus_de_50_ans,total_femmes,diplome_niv_1_2,diplome_niv_3,diplome_niv_4,diplome_niv_5,diplome_niv_5_bis,diplome_niv_6,diplome_indetermine,total_categorie_a
Bordeaux Métropole,3579,16226,5317,25122,3294,16167,5050,24511,10520,6620,10724,14103,2391,5027,248,49633
Brest Métropole,999,3759,1247,6005,867,3242,1238,5347,1689,1193,2415,4353,654,968,80,11352
CA Agglo Pays d'Issoire,196,695,385,1276,168,848,433,1449,s.s,261,592,1202,185,251,s.s,2725
CA Agglo du Pays de Dreux,561,2149,879,3589,460,2242,883,3585,488,639,1456,2961,612,989,29,7174
CA Agglomération du Choletais,371,1212,574,2157,316,1296,652,2264,404,468,864,1718,311,631,25,4421
CA Alès Agglomération,756,3012,1571,5339,562,2834,1475,4871,705,926,2065,4677,734,1084,19,10210
CA Amiens Métropole,1091,4367,1530,6988,972,3667,1278,5917,1536,1090,2650,4501,1217,1849,62,12905
CA Annemasse- les Voirons-Agglomération,286,2332,773,3391,307,2053,655,3015,833,689,1374,2352,333,770,55,6406
CA Annonay Rhône Agglo,194,774,333,1301,148,701,321,1170,s.s,240,541,1013,157,296,s.s,2471
CA Ardenne Métropole,599,2607,1299,4505,560,2176,1084,3820,422,602,1555,3964,712,1045,25,8325
CA Arlysère,173,639,320,1132,151,599,294,1044,221,217,406,904,128,284,16,2176
CA Bassin d'Arcachon Sud-Pôle Atlantique (Cobas),274,1042,538,1854,221,1225,715,2161,s.s,553,938,1625,189,210,s.s,4015
"CA Beaune, Côte et Sud - Communauté Beaune-Chagny-Nolay",160,598,294,1052,145,660,297,1102,s.s,229,401,864,125,274,s.s,2154
CA Bergeracoise,297,1084,480,1861,206,1029,521,1756,s.s,346,728,1583,245,463,s.s,3617
CA Bourges Plus,452,1868,721,3041,368,1667,715,2750,528,561,1072,2436,386,794,14,5791
CA Cannes Pays de Lérins,778,3977,1976,6731,640,3819,1989,6448,1625,1654,3088,4327,890,1545,50,13179
CA Cap Excellence,742,3593,1875,6210,879,5178,2452,8509,851,1237,3171,5457,1465,2455,83,14719
CA Carcassonne Agglo,577,2156,1103,3836,508,2150,1132,3790,551,733,1688,3178,544,903,29,7626
CA Caux Vallée de Seine,424,1103,446,1973,407,1224,559,2190,200,333,835,2000,317,465,13,4163
CA Chambéry Métropole-Coeur des Bauges,409,1976,795,3180,376,1831,684,2891,999,701,1255,2187,290,614,25,6071
CA Chartres Métropole,497,2030,794,3321,417,1977,765,3159,631,684,1285,2561,509,779,31,6480
CA Chauny Tergnier la Fère,368,1258,563,2189,340,1131,472,1943,151,298,802,1984,334,549,14,4132
CA Châteauroux Métropole,336,1350,572,2258,297,1228,567,2092,278,367,816,1957,377,529,26,4350
CA Civis (Communauté Intercommunale des Villes Solidaires),1830,8797,4388,15015,2035,9562,4195,15792,1149,1652,5416,11953,3268,7336,33,30807
CA Clisson Sèvre et Maine Agglo,124,434,179,737,119,564,217,900,286,246,364,563,70,85,23,1637
CA Coeur d'Essonne Agglomération,663,2581,1068,4312,524,2855,901,4280,1239,1077,2008,2614,590,1006,58,8592
CA Colmar Agglomération,419,1875,797,3091,394,1630,701,2725,604,520,1043,2394,461,776,18,5816
CA Communauté Paris-Saclay,779,3983,1567,6329,619,3936,1322,5877,2890,1741,2513,3087,629,1270,76,12206
CA Concarneau Cornouaille Agglomération,194,776,386,1356,143,703,393,1239,320,309,609,1039,152,151,15,2595
CA Creil Sud Oise,506,2282,856,3644,420,2202,655,3277,511,593,1491,2382,637,1276,31,6921
CA Dinan Agglomération,328,1308,693,2329,315,1230,679,2224,443,508,1013,2021,273,280,15,4553
CA Dracénoise,566,1971,962,3499,526,2053,1035,3614,530,700,1524,3129,512,698,20,7113
CA Durance-Lubéron-Verdon Agglomération,301,1220,632,2153,278,1327,622,2227,435,437,876,1847,311,464,10,4380
CA Ecla (Espace Communautaire Lons Agglomération),144,469,213,826,108,377,170,655,s.s,121,291,644,104,183,s.s,1481
"CA Epernay, Coteaux et Plaine de Champagne",221,800,290,1311,178,701,293,1172,157,210,442,1091,180,383,20,2483
CA Etampois Sud Essonne,184,737,328,1249,187,750,267,1204,247,277,547,904,158,306,14,2453
CA Evreux Portes de Normandie,514,1994,897,3405,418,1869,720,3007,479,548,1281,2590,565,914,35,6412
CA Flers Agglo,233,792,354,1379,192,777,327,1296,159,219,488,1281,162,353,13,2675
CA Fougères Agglomération,198,652,283,1133,157,622,256,1035,171,235,417,950,152,227,16,2168
CA Fécamp Caux Littoral Agglomération,232,639,314,1185,206,573,318,1097,s.s,154,405,1130,168,305,s.s,2282
CA Gap-Tallard-Durance,198,794,314,1306,162,715,362,1239,286,286,577,1008,160,217,11,2545
CA Golfe du Morbihan - Vannes Agglomération,565,2421,999,3985,456,2414,1105,3975,1374,1202,1794,2771,370,413,36,7960
CA Grand Auch Coeur de Gascogne,132,500,251,883,131,428,212,771,s.s,172,373,698,94,164,s.s,1654
CA Grand Belfort,381,1679,808,2868,355,1611,740,2706,562,561,1075,2238,417,677,44,5574
CA Grand Lac- Communauté d'Agglomération du Lac du Bourget,212,907,423,1542,191,970,473,1634,s.s,450,655,1130,161,228,s.s,3176
CA Grand Montauban,415,1723,661,2799,384,1720,617,2721,484,450,1131,1960,439,1036,20,5520
CA Grand Paris Sud Seine Essonne Sénart,1204,6099,2465,9768,1216,6417,1943,9576,2474,2198,4674,5626,1448,2782,142,19344
CA Grand Sud Caraïbe,643,2817,1985,5445,733,3641,2127,6501,450,816,2375,4707,1255,2295,48,11946
CA Grand-Poitiers,773,2933,923,4629,612,2459,830,3901,1354,1024,1860,3040,423,786,43,8530
CA Guingamp-Paimpol Armor-Argoat Agglomération,255,1077,600,1932,237,992,572,1801,325,381,789,1705,238,282,13,3733
"CA Havraise (Co,D,A,H,)",1539,5645,2188,9372,1415,4680,2008,8103,1414,1359,3565,7800,1176,2097,64,17475
CA Hermitage-Tournonais-Herbasse-Pays de Saint Félicien,235,964,421,1620,196,915,407,1518,307,314,616,1203,202,484,12,3138
CA Hérault-Méditerranée,569,2277,1157,4003,524,2223,1144,3891,516,766,1709,3517,589,776,21,7894
CA Intercommunale de la Réunion Est (Cirest),1292,5632,2546,9470,1268,5733,2325,9326,462,943,3581,7957,1776,4029,48,18796
CA Intercommunale du Nord de la Réunion (Cinor),1777,7893,3647,13317,1915,8630,3332,13877,1587,1767,5565,9887,2656,5669,63,27194
CA Lannion-Trégor Communauté,371,1410,708,2489,287,1217,680,2184,594,525,1037,1914,300,289,14,4673
CA Limoges Métropole,917,3482,1246,5645,822,3124,1084,5030,1240,988,2185,3971,701,1562,28,10675
CA Lisieux Normandie,352,1019,468,1839,308,921,411,1640,189,236,603,1680,268,490,13,3479
CA Loire Forez,340,1066,566,1972,335,1141,638,2114,318,403,906,1839,213,393,14,4086
CA Lorient Agglomération,801,3198,1483,5482,713,2936,1493,5142,1367,1236,2249,4346,595,789,42,10624
CA Luberon Monts de Vaucluse,319,1239,623,2181,286,1240,634,2160,374,430,831,1477,321,898,10,4341
CA Marne et Gondoire,250,1394,564,2208,249,1387,509,2145,826,649,1011,1241,246,361,19,4353
CA Maubeuge Val de Sambre,1068,3932,1498,6498,907,3521,1230,5658,481,804,2681,5826,920,1421,23,12156
CA Mauges Communauté,263,887,422,1572,258,1042,508,1808,275,390,709,1428,234,332,12,3380
CA Melun Val de Seine,492,2498,1000,3990,488,2326,767,3581,844,793,1792,2344,514,1242,42,7571
CA Metz Métropole,990,4776,1932,7698,812,3963,1658,6433,1881,1425,2689,5020,966,2079,71,14131
CA Mont de Marsan Agglomération,195,792,323,1310,193,803,307,1303,s.s,284,545,1064,167,325,s.s,2613
CA Mont-Saint-Michel-Normandie,291,925,506,1722,238,830,409,1477,249,309,623,1432,217,342,27,3199
"CA Montargoise et Rives du Loing (A,M,E,)",344,1340,642,2326,358,1400,531,2289,319,321,799,1880,426,839,31,4615
CA Montluçon Communauté,309,1124,583,2016,243,1031,505,1779,243,291,685,1792,290,482,12,3795
CA Montélimar Agglomération,319,1240,594,2153,291,1262,606,2159,374,440,844,1747,301,586,20,4312
CA Morlaix Communauté,264,940,443,1647,191,882,456,1529,341,353,727,1351,179,214,11,3176
CA Moulins Communauté,279,990,487,1756,222,900,443,1565,201,274,578,1529,282,440,17,3321
CA Mulhouse Alsace Agglomération,1314,6136,2646,10096,1046,5045,2134,8225,1505,1540,3501,7747,1190,2755,83,18321
CA Mâconnais Beaujolais Agglomération,273,1167,466,1906,261,1084,444,1789,357,344,701,1452,271,552,18,3695
CA Paris - Vallée de la Marne,773,3625,1513,5911,660,3671,1325,5656,1745,1454,2733,3497,733,1358,47,11567
CA Pau Béarn Pyrénées,648,2526,1153,4327,520,2537,1144,4201,1391,1054,1784,3142,367,757,33,8528
CA Pays Foix-Varilhes,140,555,262,957,145,553,249,947,s.s,179,418,798,97,190,s.s,1904
CA Pays de Montbéliard Agglomération,506,2185,1090,3781,456,2060,1060,3576,471,695,1429,3237,537,968,20,7357
CA Plaine Vallée,617,2705,1283,4605,475,2782,1114,4371,1671,1285,2066,2496,530,896,32,8976
CA Pornic Agglo Pays de Retz,214,657,343,1214,165,712,448,1325,324,374,626,982,113,108,12,2539
"CA Porte de l'Isère (C,A,P,I)",418,1746,645,2809,434,1862,685,2981,560,578,1205,2223,442,736,46,5790
CA Portes de France-Thionville,302,1386,589,2277,256,1252,562,2070,510,449,891,1759,251,466,21,4347
CA Privas Centre Ardèche,229,677,343,1249,177,635,334,1146,216,244,503,950,164,302,16,2395
CA Provence-Alpes-Agglomération,219,960,473,1652,187,849,461,1497,s.s,283,630,1423,210,321,s.s,3149
CA Quimper Bretagne Occidentale,407,1688,670,2765,354,1433,577,2364,666,617,1134,1993,304,384,31,5129
CA Rambouillet Territoires,202,711,370,1283,145,754,372,1271,655,418,508,684,106,165,18,2554
CA Roannais Agglomération,379,1545,757,2681,365,1439,738,2542,382,441,1002,2360,341,680,17,5223
CA Rochefort Océan,261,1050,539,1850,224,1065,569,1858,s.s,382,731,1756,208,297,s.s,3708
CA Rodez Agglomération,190,677,260,1127,180,584,257,1021,246,259,435,835,119,239,15,2148
CA Roissy Pays de France,1646,7171,3355,12172,1578,7018,2725,11321,2198,2280,5822,7094,1911,4089,99,23493
CA Royan Atlantique,358,1357,726,2441,276,1317,936,2529,429,558,1102,2236,305,329,11,4970
CA Saint Germain Boucles de Seine,704,4348,2274,7326,584,4433,1876,6893,4060,1914,2728,3359,677,1379,102,14219
CA Saint-Brieuc Armor Agglomération,588,2487,1061,4136,520,2173,1001,3694,780,825,1614,3272,554,754,31,7830
CA Saint-Louis Agglomération,199,1236,794,2229,212,1063,565,1840,510,427,764,1667,225,460,16,4069
CA Saint-Lô Agglo,256,900,380,1536,234,815,334,1383,s.s,262,541,1367,179,352,s.s,2919
CA Sarreguemines Confluences,254,1087,642,1983,205,863,518,1586,214,258,663,1614,261,548,11,3569
CA Saumur Val de Loire,487,1638,743,2868,429,1595,832,2856,344,412,960,2419,560,1011,18,5724
CA Seine Eure,351,1185,535,2071,309,1075,501,1885,278,331,820,1610,353,538,26,3956
CA Seine Normandie Agglomération,370,1304,605,2279,322,1265,635,2222,439,449,975,1720,334,563,21,4501
CA Sud Sainte Baume,260,883,497,1640,163,939,533,1635,s.s,450,773,1267,194,135,s.s,3275
CA Tarbes-Lourdes-Pyrénées,624,2568,1303,4495,568,2502,1448,4518,699,882,1859,4002,639,916,16,9013
CA Terre de Provence,278,997,584,1859,238,1067,534,1839,s.s,331,759,1378,254,643,s.s,3698
CA Territoire de la Côte Ouest (Tco),2014,10110,4815,16939,2312,10646,4305,17263,1539,2016,5518,13152,3669,8259,49,34202
CA Territoires Vendômois,222,666,382,1270,140,627,355,1122,s.s,227,439,1048,173,293,s.s,2392
CA Thonon Agglomération,261,1380,625,2266,221,1336,542,2099,624,518,901,1660,212,426,24,4365
CA Toulon Provence Méditerranée,1975,8028,3712,13715,1661,7456,3347,12464,2779,2840,5791,10206,1931,2527,105,26179
CA Troyes Champagne Métropole,838,3889,1670,6397,894,3782,1396,6072,928,984,2221,5224,1077,1996,39,12469
CA Tulle Agglo,156,527,272,955,121,504,240,865,154,153,389,788,116,207,13,1820
CA Val Parisis,846,4092,1818,6756,711,4095,1623,6429,2231,1769,3098,3868,804,1334,81,13185
CA Val d'Europe Agglomération,97,376,158,631,75,511,172,758,298,257,348,320,69,87,10,1389
CA Val d'Yerres Val de Seine,600,2487,1045,4132,489,2566,887,3942,1209,1038,2005,2404,541,839,38,8074
CA Val de Garonne Agglomération,241,950,439,1630,252,982,499,1733,204,282,599,1450,255,562,11,3363
CA Valence Romans Agglo,985,4134,1882,7001,872,3941,1657,6470,1408,1363,2657,5152,977,1848,66,13471
CA Valenciennes Métropole,1270,5059,1958,8287,1170,4157,1597,6924,1024,1211,3067,6836,1114,1918,41,15211
CA Var Esterel Méditerranée (Cavem),564,2384,1191,4139,486,2375,1230,4091,764,982,1864,3271,566,769,14,8230
CA Ventoux-Comtat-Venaissin (Cove),357,1503,754,2614,338,1515,731,2584,389,484,1002,2088,352,864,19,5198
"CA Versailles Grand Parc (C,A,V,G,P,)",478,2715,1327,4520,361,2985,1081,4427,3180,1341,1610,1824,319,609,64,8947
CA Vichy Communauté,356,1350,757,2463,314,1191,692,2197,s.s,452,913,1993,414,459,s.s,4660
CA Viennagglo,263,1050,412,1725,251,1027,421,1699,392,401,697,1270,245,401,18,3424
CA Villefranche Beaujolais Saône,262,1233,508,2003,244,1286,448,1978,424,385,788,1473,283,593,35,3981
CA Vitré Communauté,242,751,289,1282,200,766,342,1308,279,296,533,1096,163,198,25,2590
CA d'Agen,373,1498,627,2498,350,1478,694,2522,457,562,1054,2065,318,545,19,5020
CA d'Arles-Crau-Camargue-Montagnette,505,1933,1079,3517,446,2057,1010,3513,582,602,1450,2623,484,1261,28,7030
CA d'Epinal,525,1896,912,3333,443,1633,907,2983,380,514,1210,2962,440,778,32,6316
CA d'hénin-Carvin,775,2810,1191,4776,666,2354,843,3863,375,699,1999,4013,599,930,24,8639
CA de Bar-Le-Duc - Sud Meuse,130,562,275,967,127,442,222,791,s.s,134,355,810,107,237,s.s,1758
CA de Bastia,208,864,395,1467,178,813,334,1325,309,251,674,901,258,386,13,2792
CA de Blois ''agglopolys'',390,1728,813,2931,309,1567,668,2544,558,547,1018,2060,446,807,39,5475
"CA de Béthune-Bruay, Artois-Lys Romane",1568,4941,2046,8555,1327,4445,1790,7562,720,1338,3599,7771,1052,1606,31,16117
CA de Béziers-Méditerranée,794,3500,1534,5828,768,2973,1342,5083,739,959,2219,4698,934,1341,21,10911
CA de Cambrai,501,1747,829,3077,405,1533,768,2706,369,501,1231,2603,354,714,11,5783
CA de Castres Mazamet,410,1268,622,2300,386,1306,631,2323,350,414,975,1992,352,529,11,4623
CA de Cergy-Pontoise,815,4150,1494,6459,710,4194,1416,6320,1893,1607,2969,3746,837,1625,102,12779
"CA de Chaumont, du Bassin Nogentais et du Bassin de Bologne Vignory Froncles",141,554,286,981,152,472,252,876,s.s,146,344,840,153,262,s.s,1857
CA de Châlons-En-Champagne,313,1315,472,2100,287,1132,391,1810,s.s,313,723,1805,270,552,s.s,3910
CA de Forbach Porte de France,346,1710,852,2908,281,1460,835,2576,306,397,983,2368,518,901,11,5484
CA de Haguenau,334,1138,640,2112,319,1171,533,2023,351,374,777,1717,310,593,13,4135
CA de Laval,289,1242,457,1988,281,1110,352,1743,445,381,733,1380,260,520,12,3731
CA de Lens - Liévin,1625,5546,2206,9377,1288,4261,1624,7173,724,1242,3619,7931,1050,1933,51,16550
CA de Longwy,203,1243,508,1954,156,861,377,1394,259,288,705,1428,211,443,14,3348
CA de Nevers,254,940,390,1584,234,733,355,1322,187,215,592,1358,184,355,15,2906
CA de Nîmes Métropole,1552,6441,3018,11011,1315,5518,2433,9266,1799,1990,4108,7492,1672,3102,114,20277
CA de Saint Quentin en Yvelines,719,3475,1360,5554,612,3431,1170,5213,1858,1373,2310,3144,611,1423,48,10767
CA de Saint-Dizier Der et Blaise,260,984,516,1760,239,991,509,1739,122,212,669,1757,268,457,14,3499
CA de Saint-Dié-Des-Vosges,353,1294,863,2510,325,1096,768,2189,217,339,891,2171,480,584,17,4699
CA de Saintes,245,866,422,1533,214,838,461,1513,s.s,324,669,1385,197,206,s.s,3046
CA de Sophia Antipolis,720,3393,1774,5887,594,3416,1744,5754,2008,1561,2578,3687,735,1034,38,11641
CA de Vesoul,153,551,240,944,124,451,222,797,s.s,130,311,821,124,229,s.s,1741
CA de l'Albigeois (C2a),395,1375,574,2344,343,1406,562,2311,531,454,1025,1883,292,459,11,4655
CA de l'Auxerrois,293,1036,423,1752,213,836,423,1472,265,285,602,1408,218,421,25,3224
CA de l'Espace Sud de la Martinique,658,3182,2201,6041,620,4195,2388,7203,890,1149,2590,5446,1191,1927,51,13244
CA de l'Ouest Rhodanien,135,623,290,1048,143,527,273,943,s.s,158,405,883,162,220,s.s,1991
CA de la Baie de Somme,334,985,430,1749,289,817,414,1520,148,205,593,1515,317,481,10,3269
CA de la Porte du Hainaut,982,3875,1597,6454,918,3419,1292,5629,559,809,2483,5790,822,1587,33,12083
CA de la Presqu'île de Guérande Atlantique (Cap Atlantique),304,957,551,1812,233,1022,655,1910,569,509,852,1436,182,142,32,3722
CA de la Provence Verte,490,1583,796,2869,413,1768,846,3027,522,704,1332,2489,412,413,24,5896
CA de la Riviera Française,243,1373,623,2239,259,1363,685,2307,571,546,1152,1528,345,390,14,4546
CA de la Rochelle,731,3048,1217,4996,615,2752,1204,4571,1447,1222,1986,3716,500,665,31,9567
CA de la Région Dieppoise,285,956,467,1708,253,778,422,1453,164,205,581,1477,254,469,11,3161
CA de la Région Nazairienne et de l'Estuaire (Carene),551,1927,863,3341,492,1847,848,3187,674,655,1414,2859,393,497,36,6528
CA de la Région de Château-Thierry,318,981,417,1716,258,907,431,1596,155,262,639,1517,268,452,19,3312
CA de la Région de Compiègne et de la Basse Automne,299,1428,540,2267,314,1421,519,2254,592,427,925,1702,317,535,23,4521
CA des Deux Baies en Montreuillois,411,1205,578,2194,338,942,478,1758,277,353,974,1776,246,310,16,3952
CA du Bassin d'Aurillac,168,567,274,1009,115,486,296,897,s.s,181,361,848,148,198,s.s,1906
CA du Bassin de Bourg-En-Bresse,436,1564,677,2677,346,1604,675,2625,476,552,1071,2156,347,660,40,5302
CA du Bassin de Brive,340,1400,692,2432,343,1581,718,2642,434,519,1109,2085,290,623,14,5074
CA du Bassin de Thau,741,2902,1488,5131,610,2566,1388,4564,807,1019,2171,4138,664,853,43,9695
CA du Beauvaisis,585,1938,777,3300,537,1989,682,3208,472,533,1210,2685,622,962,24,6508
CA du Bocage Bressuirais,217,723,378,1318,188,642,346,1176,167,225,486,1102,138,358,18,2494
CA du Boulonnais,688,2576,1005,4269,707,2163,957,3827,451,608,1583,3618,805,997,34,8096
CA du Calaisis,816,2697,1059,4572,675,2096,956,3727,358,541,1753,4000,535,1074,38,8299
CA du Centre Littoral,759,2927,1554,5240,921,5101,1641,7663,682,721,2219,3802,1158,4239,82,12903
CA du Centre de la Martinique,894,4329,2507,7730,960,5762,2909,9631,1455,1673,3655,6400,1489,2644,45,17361
CA du Cotentin,504,1642,702,2848,476,1530,716,2722,485,464,1116,2660,372,440,33,5570
"CA du Douaisis [c,A,D,]",1003,3596,1540,6139,873,2912,1115,4900,574,843,2403,5071,786,1315,47,11039
CA du Gard Rhodanien,353,1314,639,2306,326,1270,684,2280,377,448,998,1902,265,564,32,4586
CA du Grand Angoulême,623,2620,1060,4303,600,2374,1067,4041,806,825,1704,3518,508,951,32,8344
CA du Grand Annecy,482,2339,782,3603,422,2322,762,3506,1651,963,1402,2141,324,558,70,7109
CA du Grand Avignon (Coga),1055,4725,1990,7770,924,4440,1734,7098,1597,1477,3006,5422,962,2352,52,14868
CA du Grand Besançon,843,3390,1272,5505,634,2813,1114,4561,1521,1038,2053,3593,585,1217,59,10066
CA du Grand Cahors,191,835,363,1389,138,701,389,1228,219,226,582,1068,193,318,11,2617
CA du Grand Cognac,274,883,406,1563,216,921,441,1578,s.s,267,606,1430,194,338,s.s,3141
CA du Grand Dax,240,917,470,1627,221,994,530,1745,s.s,361,663,1556,203,307,s.s,3372
CA du Grand Dole,175,708,288,1171,144,720,293,1157,s.s,240,505,998,135,232,s.s,2328
CA du Grand Guéret,119,458,201,778,98,319,155,572,s.s,106,256,651,86,164,s.s,1350
CA du Grand Sénonais,232,1066,466,1764,212,950,455,1617,246,270,609,1464,290,491,11,3381
CA du Grand Verdun,133,512,255,900,132,406,196,734,63,113,288,818,126,215,11,1634
CA du Grand Villeneuvois,219,827,406,1452,201,826,424,1451,s.s,214,600,1261,233,441,s.s,2903
CA du Libournais,495,1682,741,2918,445,1929,797,3171,379,481,1210,2750,443,810,16,6089
CA du Niortais,470,1702,734,2906,401,1579,598,2578,602,589,1142,2363,281,478,29,5484
CA du Nord Basse-Terre,529,2304,1470,4303,618,3329,1784,5731,597,939,2024,3894,919,1627,34,10034
CA du Nord Grande Terre,462,2112,1320,3894,481,2670,1476,4627,344,614,1652,3343,929,1603,36,8521
CA du Pays Ajaccien,322,1219,626,2167,299,1274,564,2137,445,403,995,1493,392,555,21,4304
CA du Pays Basque,1039,4881,1962,7882,862,4999,2150,8011,2655,2340,3621,5754,629,834,60,15893
CA du Pays Châtelleraudais,357,1022,534,1913,267,1062,488,1817,244,292,730,1793,228,429,14,3730
CA du Pays Nord Martinique,723,2680,1983,5386,754,3632,2263,6649,532,859,2401,4959,1058,2199,27,12035
CA du Pays Voironnais,293,1074,509,1876,239,1092,495,1826,561,490,720,1359,238,311,23,3702
CA du Pays de Fontainebleau,187,832,387,1406,158,814,369,1341,592,409,597,733,147,249,20,2747
CA du Pays de Grasse,443,1662,887,2992,411,1823,929,3163,711,715,1349,2275,449,638,18,6155
CA du Pays de Laon,333,1067,412,1812,252,902,409,1563,152,200,573,1513,310,617,10,3375
CA du Pays de Meaux,404,1783,684,2871,379,1836,591,2806,497,607,1283,2010,485,755,40,5677
CA du Pays de Quimperlé,176,624,377,1177,141,620,330,1091,271,316,527,909,121,106,18,2268
CA du Pays de Saint Malo - Saint Malo Agglomération,315,1270,536,2121,288,1141,631,2060,572,476,912,1708,237,239,37,4181
CA du Pays de Saint-Omer,579,1846,700,3125,500,1733,777,3010,333,554,1248,2843,410,730,17,6135
CA du Pays de l'Or,258,1179,580,2017,233,1023,549,1805,526,565,904,1314,215,273,25,3822
CA du Puy-En-Velay,280,1105,617,2002,226,941,579,1746,317,396,764,1649,229,376,17,3748
CA du Rabastinois - Tarn et Dadou - Vère Grésigne et Pays Salvagnacois,334,1197,600,2131,268,1272,567,2107,460,478,940,1666,267,414,13,4238
CA du Saint-Quentinois,596,2255,807,3658,541,1800,705,3046,303,402,1185,3153,632,1009,20,6704
CA du Sicoval,241,883,352,1476,188,1037,405,1630,704,504,693,885,138,166,16,3106
CA du Soissonnais,302,1291,619,2212,264,1065,452,1781,203,301,706,1815,348,605,15,3993
CA du Sud,1285,6226,3274,10785,1431,7178,3344,11953,672,1109,4069,8739,2483,5647,19,22738
CA du Val de Fensch,335,1377,607,2319,311,1278,573,2162,265,365,905,2087,261,578,20,4481
CA la Riviéra du Levant,472,2351,1375,4198,482,2949,1601,5032,684,831,1945,3280,1022,1422,46,9230
CA la Roche Sur Yon - Agglomération,446,1396,551,2393,370,1380,605,2355,481,462,994,1912,312,571,16,4748
CA le Grand Chalon,404,1706,832,2942,347,1670,750,2767,486,555,1069,2452,369,767,11,5709
CA le Grand Narbonne,836,2927,1436,5199,687,2734,1606,5027,797,965,2277,4471,758,890,68,10226
CA le Grand Périgueux,471,1758,803,3032,358,1577,688,2623,473,537,1256,2388,369,611,21,5655
CA le Muretain Agglo,505,1522,805,2832,405,1857,742,3004,677,743,1334,2243,345,477,17,5836
CA les Sables d'Olonne Agglomération,203,728,443,1374,170,653,531,1354,s.s,322,598,1119,178,217,s.s,2728
CC Adour Madiran,91,271,201,563,80,302,170,552,s.s,116,228,534,72,81,s.s,1115
CC Agglo Saint-Avold Centre Mosellan,239,926,419,1584,213,751,421,1385,159,242,593,1373,221,359,22,2969
CC Agly Fenouillèdes,24,139,57,220,22,133,66,221,s.s,38,98,185,40,48,s.s,441
CC Airvaudais-Val du Thouet,19,71,59,149,14,68,47,129,17,20,52,138,s.s,42,s.s,278
CC Albret Communauté,91,349,177,617,89,366,224,679,s.s,114,249,539,92,203,s.s,1296
CC Alpes d'Azur,27,132,82,241,18,153,75,246,s.s,51,103,202,45,52,s.s,487
"CC Alpes-Provence-Verdon ""sources de Lumière""",33,187,122,342,20,188,141,349,s.s,74,149,282,53,57,s.s,691
CC Altitude 800,s.s,52,s.s,74,11,56,18,85,10,13,42,76,s.s,11,s.s,159
CC Ambert Livradois Forez,77,334,254,665,59,276,210,545,s.s,132,271,503,88,122,s.s,1210
CC Amognes Coeur du Nivernais,29,67,64,160,13,73,54,140,s.s,16,50,152,23,39,s.s,300
CC Andaine - Passais,47,131,78,256,39,122,61,222,s.s,32,100,205,31,66,s.s,478
CC Anjou Bleu Communauté,150,400,184,734,123,374,143,640,s.s,106,317,531,143,164,s.s,1374
CC Anjou Loir et Sarthe,97,272,164,533,82,315,151,548,s.s,93,223,475,85,116,s.s,1081
"CC Arbois, Poligny, Salins, Coeur du Jura",64,205,105,374,44,162,120,326,s.s,83,134,315,37,62,s.s,700
CC Arc Sud Bretagne,60,321,203,584,84,327,204,615,128,174,278,481,65,63,10,1199
"CC Ardenne, Rives de Meuse",130,502,310,942,106,502,283,891,74,122,312,854,170,290,11,1833
CC Ardennes Thiérache,52,128,68,248,31,125,66,222,s.s,34,73,229,44,71,s.s,470
CC Ardèche Rhône Coiron,113,385,186,684,106,397,174,677,s.s,114,266,628,116,140,s.s,1361
CC Ardèche des Sources et Volcans,37,180,95,312,36,169,123,328,s.s,60,159,275,38,51,s.s,640
CC Argentan Intercom,117,423,192,732,117,374,186,677,s.s,83,246,703,99,199,s.s,1409
CC Argonne-Meuse,22,74,53,149,27,79,31,137,s.s,20,70,137,14,33,s.s,286
CC Arize Lèze,34,202,111,347,32,183,96,311,s.s,76,134,258,35,45,s.s,658
CC Armagnac Adour,18,74,35,127,12,77,45,134,18,25,71,104,18,25,",",261
CC Arnon Boischaut Cher,33,95,69,197,31,97,72,200,s.s,33,82,193,31,37,s.s,397
CC Artagnan de Fezensac,18,52,43,113,14,60,47,121,27,28,55,88,19,17,",",234
CC Arve et Salève,50,254,128,432,41,274,95,410,s.s,116,157,333,40,56,s.s,842
CC Astarac Arros en Gascogne,17,57,51,125,18,50,40,108,25,25,50,103,s.s,22,s.s,233
CC Au Pays de la Roche Aux Fées,67,236,92,395,51,249,104,404,s.s,100,160,331,49,71,s.s,799
CC Aubrac Lot Causse et Pays de Chanac,20,68,40,128,13,67,31,111,s.s,34,68,84,s.s,15,s.s,239
CC Aubrac et Carladez,12,51,25,88,11,72,50,133,19,28,43,93,16,22,",",221
CC Aunis Atlantique,103,352,147,602,87,372,186,645,s.s,121,274,606,59,74,s.s,1247
CC Aunis Sud,130,433,178,741,115,436,207,758,s.s,171,282,707,97,117,s.s,1499
CC Auray Quiberon Terre Atlantique,340,1357,680,2377,292,1319,777,2388,632,649,1168,1875,218,203,20,4765
CC Aure Louron,18,82,32,132,17,90,55,162,s.s,47,77,101,14,15,s.s,294
CC Auxonne Pontailler Val de Saône,88,260,139,487,77,303,150,530,s.s,83,180,480,71,142,s.s,1017
CC Auzon Communauté,22,121,77,220,36,115,86,237,s.s,34,80,261,28,31,s.s,457
"CC Avallon, Vézelay, Morvan",68,267,127,462,57,226,123,406,s.s,70,152,431,59,88,s.s,868
CC Aveyron Ségala Viaur,17,56,28,101,16,51,27,94,18,15,55,85,11,11,",",195
CC Avre Luce Noye,95,264,109,468,83,236,101,420,s.s,86,183,396,86,87,s.s,888
CC Aygues-Ouvèze en Provence (Ccaop),79,258,131,468,60,356,168,584,s.s,146,238,418,65,99,s.s,1052
CC Bassée-Montois,81,207,138,426,63,275,163,501,s.s,101,221,393,74,64,s.s,927
CC Bastides de Lomagne,18,79,69,166,17,110,62,189,41,48,75,144,23,24,",",355
CC Bastides et Vallons du Gers,28,80,46,154,11,65,59,135,19,38,59,134,18,21,",",289
CC Baugeois Vallée,114,384,188,686,98,409,200,707,s.s,115,296,632,100,153,s.s,1393
CC Bazois Loire Morvan,38,138,143,319,35,129,133,297,s.s,43,112,309,49,66,s.s,616
CC Beaucaire Terre d'Argence,214,910,499,1623,198,917,379,1494,153,198,607,1051,275,818,15,3117
CC Beauce Val de Loire,49,211,94,354,57,196,109,362,s.s,63,149,322,55,74,s.s,716
CC Beaujolais Pierres Dorées,96,410,215,721,89,460,211,760,312,228,304,477,64,80,16,1481
CC Berg et Coiron,38,131,50,219,36,145,54,235,s.s,59,95,179,31,29,s.s,454
CC Berry Grand Sud,52,164,129,345,24,123,124,271,s.s,35,118,312,44,77,s.s,616
CC Berry Loire Puisaye,81,264,160,505,70,292,177,539,s.s,69,187,529,85,135,s.s,1044
CC Berry-Loire-Vauvise,24,79,45,148,20,59,42,121,11,23,47,135,21,32,",",269
CC Billom Communauté,90,322,140,552,60,301,126,487,s.s,119,222,434,77,96,s.s,1039
CC Bièvre Isère,176,523,319,1018,135,707,335,1177,197,237,444,968,138,196,15,2195
CC Blangy-Pont l'Evêque Intercom,59,185,113,357,46,169,104,319,s.s,94,132,278,43,59,s.s,676
CC Bouzonvillois-Trois Frontières,65,278,179,522,69,262,145,476,s.s,96,225,434,61,113,s.s,998
CC Brenne - Val de Creuse,65,196,121,382,55,160,100,315,s.s,51,137,339,39,90,s.s,697
CC Bresse Haute Seille,51,165,89,305,33,164,91,288,s.s,75,112,275,32,41,s.s,593
CC Bresse Louhannaise Intercom',98,291,165,554,95,305,194,594,s.s,85,203,559,81,146,s.s,1148
CC Bresse Revermont 71,36,89,44,169,26,102,59,187,s.s,37,58,170,28,41,s.s,356
CC Bretagne Porte de Loire Communauté,93,302,131,526,71,333,118,522,118,117,243,445,50,65,10,1048
CC Bretagne Romantique,88,359,173,620,80,432,165,677,s.s,161,281,542,62,91,s.s,1297
CC Briance Combade,17,61,40,118,15,52,37,104,27,17,52,101,12,13,",",222
CC Briance Sud Haute Vienne,23,81,50,154,12,95,49,156,38,36,74,123,14,25,",",310
CC Brie Nangissienne,109,286,146,541,96,345,147,588,s.s,117,272,452,91,127,s.s,1129
CC Brie des Rivières et Châteaux,89,356,165,610,73,352,143,568,s.s,159,295,426,71,96,s.s,1178
CC Bruyères-Vallons des Vosges,69,197,113,379,64,196,122,382,s.s,54,145,393,68,74,s.s,761
CC Bugey Sud,110,437,225,772,100,399,221,720,141,143,299,673,77,138,21,1492
CC Buëch-Dévoluy,23,131,70,224,21,109,49,179,s.s,49,84,165,26,30,s.s,403
CC Cagire Garonne Salat,60,212,147,419,52,217,140,409,s.s,80,202,354,55,52,s.s,828
CC Campagne-De-Caux,69,114,54,237,41,135,86,262,s.s,54,101,235,26,46,s.s,499
CC Canaux et Forêts en Gâtinais,104,322,233,659,81,348,170,599,s.s,111,228,581,107,148,s.s,1258
CC Cap Sizun - Pointe du Raz,45,162,114,321,37,155,134,326,s.s,79,149,272,35,27,s.s,647
CC Capcir Haut Conflent,20,96,42,158,11,87,50,148,36,31,73,127,17,22,",",306
CC Carmausin-Ségala,153,479,262,894,113,470,263,846,s.s,138,348,827,132,171,s.s,1740
CC Carnelle Pays-De-France,82,291,176,549,88,297,153,538,s.s,163,264,353,65,64,s.s,1087
CC Castelnaudary Lauragais Audois,112,420,176,708,82,474,207,763,s.s,156,352,609,91,117,s.s,1471
CC Castillon/Pujols,99,349,187,635,103,371,174,648,s.s,99,239,507,110,254,s.s,1283
CC Causses Aigoual Cévennes,23,115,86,224,18,111,49,178,61,52,95,147,25,22,",",402
CC Causses et Vallée de la Dordogne,176,616,354,1146,136,618,389,1143,s.s,237,512,997,147,197,s.s,2289
CC Caux - Austreberthe,140,342,148,630,114,318,145,577,s.s,99,243,552,96,152,s.s,1207
CC Caux Estuaire,60,123,90,273,52,179,83,314,s.s,70,136,260,29,39,s.s,587
CC Cazals-Salviac,22,66,38,126,10,64,46,120,s.s,30,49,117,11,12,s.s,246
CC Centre Morbihan Communauté,110,463,231,804,116,523,229,868,s.s,167,392,726,115,138,s.s,1672
CC Centre Tarn,39,132,85,256,23,132,96,251,s.s,60,121,211,29,44,s.s,507
"CC Chablis, Villages et Terroirs",50,142,75,267,39,158,78,275,s.s,60,97,249,28,66,s.s,542
CC Chabris - Pays de Bazelle,21,74,45,140,15,66,41,122,s.s,23,36,139,18,35,s.s,262
CC Challans-Gois Communauté,146,490,280,916,151,549,353,1053,s.s,162,421,984,125,130,s.s,1969
CC Chalosse Tursan,84,230,138,452,83,270,172,525,s.s,115,201,452,58,84,s.s,977
CC Champagnole Nozeroy Jura,77,220,134,431,42,211,124,377,s.s,61,167,359,56,94,s.s,808
CC Champsaur-Valgaudemar,23,143,80,246,27,129,76,232,s.s,57,127,185,28,23,s.s,478
CC Charente-Arnoult-Coeur de Saintonge,66,207,109,382,52,217,113,382,s.s,86,153,359,47,49,s.s,764
CC Charlieu-Belmont,70,208,156,434,66,217,175,458,s.s,76,169,430,62,98,s.s,892
CC Chavanon Combrailles et Volcans,24,117,74,215,26,115,62,203,s.s,43,95,192,22,38,s.s,418
"CC Chinon, Vienne et Loire",77,309,143,529,75,274,159,508,s.s,101,218,440,64,122,s.s,1037
CC Châteaubriant-Derval,155,550,244,949,138,531,236,905,s.s,168,358,860,123,182,s.s,1854
"CC Chénérailles, Auzances/Bellegarde et Haut Pays Marchois",23,160,113,296,32,134,92,258,s.s,48,106,270,29,55,s.s,554
"CC Ciate, Bourganeuf/Royère-De-Vassivière",55,200,117,372,40,177,106,323,s.s,47,125,359,27,78,s.s,695
CC Cingal-Suisse Normande,93,266,126,485,50,290,117,457,s.s,94,180,428,64,101,s.s,942
CC Cluses-Arve et Montagnes,146,672,321,1139,132,672,332,1136,s.s,211,411,852,198,428,s.s,2275
CC Coeur Côte Fleurie,92,351,159,602,75,310,219,604,s.s,135,254,456,109,124,s.s,1206
CC Coeur Haute Lande,57,269,167,493,57,315,165,537,s.s,102,203,444,71,145,s.s,1030
CC Coeur d'Astarac en Gascogne,22,90,47,159,15,83,59,157,23,35,69,137,32,20,",",316
"CC Coeur d'Ostrevent [c,C,C,O,]",492,1531,657,2680,353,1380,502,2235,194,326,1003,2408,365,597,22,4915
CC Coeur d'Yvelines,96,377,251,724,72,415,244,731,s.s,272,329,321,52,67,s.s,1455
CC Coeur de Beauce,87,254,117,458,65,291,129,485,s.s,70,155,452,107,95,s.s,943
CC Coeur de Berry,77,193,110,380,60,206,131,397,s.s,73,166,367,46,87,s.s,777
CC Coeur de Brenne,14,42,50,106,10,47,36,93,12,17,36,90,19,25,",",199
CC Coeur de Charente,70,304,170,544,75,279,158,512,s.s,81,192,520,81,104,s.s,1056
CC Coeur de Chartreuse,41,164,88,293,43,188,72,303,s.s,81,119,238,30,39,s.s,596
CC Coeur de France,77,291,223,591,80,274,169,523,s.s,67,163,553,85,193,s.s,1114
CC Coeur de Garonne,129,477,236,842,106,546,251,903,s.s,227,368,733,109,145,s.s,1745
CC Coeur de Lozère,59,205,59,323,34,165,61,260,s.s,69,134,222,27,66,s.s,583
CC Coeur de Maurienne Arvan,40,158,76,274,33,149,80,262,s.s,51,99,234,27,56,s.s,536
CC Coeur de Nacre,80,341,152,573,69,292,168,529,s.s,150,242,405,59,73,s.s,1102
CC Coeur de Savoie,113,364,198,675,109,403,164,676,190,151,263,545,73,116,13,1351
CC Coeur de Sologne,37,117,73,227,23,92,58,173,s.s,33,74,203,42,29,s.s,400
CC Coeur de Tarentaise,31,129,56,216,19,84,47,150,s.s,29,71,138,23,76,s.s,366
CC Coeur de l'Avesnois,224,623,353,1200,189,612,240,1041,s.s,122,463,1093,184,294,s.s,2241
CC Coeur du Perche,51,109,70,230,28,107,71,206,s.s,34,85,199,30,42,s.s,436
CC Coeur du Var,208,712,366,1286,195,733,397,1325,s.s,267,555,1162,201,253,s.s,2611
CC Coeur et Coteaux du Comminges,184,585,364,1133,166,608,356,1130,s.s,192,447,1010,163,263,s.s,2263
CC Combrailles Sioule et Morge,65,206,83,354,47,229,111,387,s.s,70,168,351,46,47,s.s,741
CC Commentry Montmarault Néris Communauté,107,366,240,713,75,343,231,649,s.s,96,214,701,119,144,s.s,1362
CC Communauté Bray-Eawy,101,258,149,508,115,284,126,525,s.s,78,198,516,83,107,s.s,1033
CC Communauté Lesneven Côte des Légendes,72,265,166,503,81,303,203,587,s.s,119,284,444,63,46,s.s,1090
CC Communauté de Communes de Thann-Cernay,138,483,298,919,130,489,242,861,s.s,149,351,862,105,187,s.s,1780
CC Comtal Lot et Truyère,34,148,82,264,26,150,98,274,s.s,76,124,193,34,34,s.s,538
CC Conflent-Canigó,130,502,264,896,96,459,225,780,s.s,152,372,739,134,123,s.s,1676
CC Conques-Marcillac,20,108,63,191,30,104,57,191,s.s,59,80,139,22,18,s.s,382
CC Corbières Salanque Méditerranée,130,412,199,741,105,469,205,779,s.s,131,353,662,111,146,s.s,1520
CC Coteaux et Plaines du Pays Lafrançaisain,49,160,65,274,45,184,71,300,s.s,47,116,252,42,76,s.s,574
CC Coteaux et Vallées des Luys,21,86,47,154,18,94,56,168,s.s,38,81,138,16,28,s.s,322
CC Couesnon Marches de Bretagne,52,216,99,367,51,189,91,331,s.s,52,144,321,41,70,s.s,698
CC Couserans-Pyrénées,126,690,373,1189,96,589,333,1018,s.s,222,535,892,128,156,s.s,2207
CC Coutances Mer et Bocage,123,538,265,926,128,459,243,830,s.s,181,337,832,93,157,s.s,1756
CC Creuse Grand Sud,52,226,110,388,41,180,117,338,s.s,73,154,315,29,69,s.s,726
CC Cère et Goul en Carladès,s.s,27,s.s,61,s.s,31,s.s,58,s.s,11,32,58,s.s,s.s,s.s,119
CC Côte Landes Nature,40,183,133,356,46,230,123,399,79,96,183,322,36,39,",",755
CC Côte Ouest Centre Manche,71,203,127,401,57,211,121,389,s.s,57,147,388,51,89,s.s,790
CC Côte d'Albâtre,133,332,172,637,93,346,198,637,s.s,114,243,581,105,157,s.s,1274
CC Côte d'Emeraude,100,405,245,750,104,371,251,726,s.s,217,368,520,53,73,s.s,1476
CC Côtes de Champagne et Val de Saulx,42,138,79,259,38,151,75,264,23,45,87,260,42,66,",",523
CC Côtes de Meuse Woëvre,20,77,47,144,17,77,37,131,22,31,58,133,17,14,",",275
CC Decazeville Communauté,73,234,140,447,62,225,123,410,s.s,79,154,432,71,80,s.s,857
CC Dieulefit-Bourdeaux,27,125,70,222,30,156,77,263,s.s,63,109,173,28,26,s.s,485
CC Dombes Saône Vallée,79,355,127,561,80,370,158,608,s.s,156,249,422,58,89,s.s,1169
CC Domfront Tinchebray Interco,54,159,82,295,42,175,72,289,s.s,43,116,284,33,78,s.s,584
CC Douarnenez Communauté,74,307,173,554,66,277,168,511,s.s,125,258,420,46,54,s.s,1065
CC Dronne et Belle,30,119,80,229,27,119,68,214,s.s,49,90,190,24,47,s.s,443
CC Drôme Sud Provence,220,669,303,1192,189,876,414,1479,s.s,276,573,1123,192,301,s.s,2671
CC Dômes Sancy Artense,18,101,61,180,18,117,65,200,s.s,49,88,162,20,14,s.s,380
CC Ecueillé-Valençay,39,140,94,273,24,106,94,224,s.s,31,73,260,43,53,s.s,497
CC Eguzon - Argenton - Vallée de la Creuse,73,281,161,515,70,254,145,469,s.s,57,186,476,77,132,s.s,984
CC Elan Limousin Avenir Nature,94,299,171,564,72,255,124,451,s.s,121,208,473,64,64,s.s,1015
CC Enclave des Papes-Pays de Grignan,100,332,245,677,101,390,231,722,s.s,150,308,595,94,141,s.s,1399
CC Entr'allier Besbre et Loire,85,311,210,606,72,300,194,566,s.s,78,198,565,110,166,s.s,1172
CC Entre Aire et Meuse - Triaucourt-Vaubécourt,19,65,36,120,12,47,33,92,s.s,29,45,89,10,26,s.s,212
"CC Entre Arroux, Loire et Somme",85,250,159,494,59,228,195,482,s.s,69,181,468,81,122,s.s,976
CC Entre Beauce et Perche,81,227,112,420,51,197,100,348,s.s,71,145,371,53,75,s.s,768
CC Entre Dore et Allier,58,242,133,433,50,258,135,443,s.s,82,156,352,83,129,s.s,876
CC Entre Juine et Renarde (Ccejr),77,227,129,433,58,231,119,408,s.s,150,181,270,31,76,s.s,841
CC Entre Saône et Grosne,32,93,56,181,29,105,68,202,s.s,32,85,173,23,39,s.s,383
CC Estuaire et Sillon,96,287,146,529,85,399,146,630,s.s,189,259,432,58,57,s.s,1159
CC Eure-Madrie-Seine,116,434,159,709,130,454,188,772,s.s,148,330,632,123,147,s.s,1481
CC Falaises du Talou,95,276,136,507,67,285,154,506,s.s,84,234,461,69,122,s.s,1013
CC Faucigny-Glières,74,357,160,591,61,325,161,547,s.s,143,214,442,74,160,s.s,1138
CC Fercher Pays Florentais,46,135,82,263,44,151,79,274,34,42,107,270,28,56,",",537
CC Fier et Usses,35,159,69,263,35,164,76,275,s.s,72,126,186,32,27,s.s,538
CC Flandre Lys,171,450,221,842,124,511,183,818,s.s,173,368,732,112,165,s.s,1660
"CC Forêts, Lacs, Terres en Champagne",27,74,32,133,23,93,34,150,s.s,27,42,144,25,24,s.s,283
"CC Forêts, Seine et Suzon",14,50,20,84,17,41,32,90,34,28,34,67,s.s,s.s,s.s,174
CC Fumel Vallée du Lot,70,357,203,630,72,328,239,639,s.s,105,257,600,97,141,s.s,1269
CC Gally Mauldre,30,160,148,338,32,201,114,347,s.s,127,109,161,21,19,s.s,685
CC Gartempe - Saint Pardoux,16,61,36,113,10,50,24,84,22,19,51,82,s.s,19,s.s,197
CC Giennoises,135,459,193,787,103,452,213,768,s.s,96,291,654,128,285,s.s,1555
CC Gorges Causses Cévennes,20,106,68,194,24,138,51,213,s.s,43,86,144,18,45,s.s,407
CC Grand Orb Communauté de Communes en Languedoc,115,391,226,732,98,356,211,665,s.s,133,274,667,105,105,s.s,1397
CC Grand Sud Tarn et Garonne,164,638,261,1063,159,778,278,1215,s.s,263,541,890,158,257,s.s,2278
CC Grand-Figeac,112,523,248,883,95,463,273,831,s.s,207,376,713,100,112,s.s,1714
CC Gâtinais Val de Loing,76,236,127,439,57,266,108,431,s.s,100,176,353,75,95,s.s,870
CC Haut - Bugey,181,841,365,1387,198,866,358,1422,182,222,541,1034,252,556,22,2809
CC Haut Chemin-Pays de Pange,53,165,97,315,22,154,112,288,s.s,79,155,214,26,42,s.s,603
CC Haut Limousin en Marche,70,268,165,503,67,181,147,395,s.s,68,160,438,56,96,s.s,898
CC Haut Nivernais-Val d'Yonne,40,149,83,272,51,108,70,229,s.s,35,91,227,52,65,s.s,501
CC Haut Val de Sèvre,107,325,160,592,70,339,167,576,s.s,102,230,570,62,105,s.s,1168
CC Haut-Jura Saint-Claude,75,235,154,464,53,196,130,379,s.s,78,171,354,47,126,s.s,843
CC Haut-Léon Communauté,108,414,223,745,95,407,239,741,s.s,156,344,631,98,97,s.s,1486
CC Haute Maurienne Vanoise,19,81,36,136,13,60,28,101,s.s,29,46,83,18,38,s.s,237
CC Haute Sarthe Alpes Mancelles,97,259,147,503,75,230,127,432,s.s,69,173,480,66,109,s.s,935
CC Haute Saulx et Perthois-Val d'Ornois,56,162,106,324,47,169,123,339,s.s,55,127,309,48,84,s.s,663
CC Haute Vallée du Thoré,16,57,60,133,24,65,47,136,s.s,24,49,117,15,37,s.s,269
CC Haute-Corrèze Communauté,74,327,189,590,95,287,203,585,95,107,237,539,76,111,10,1175
CC Haute-Provence-Pays de Banon,33,172,82,287,40,206,114,360,s.s,80,164,239,38,29,s.s,647
CC Hautes Terres,31,79,65,175,s.s,64,s.s,140,s.s,24,54,163,21,22,s.s,315
CC Houve-Pays Boulageois,84,220,121,425,57,256,149,462,s.s,98,184,400,58,89,s.s,887
CC Inter-Caux-Vexin,186,473,243,902,108,371,226,705,s.s,167,391,654,84,113,s.s,1607
CC Interco Normandie Sud Eure,183,648,340,1171,174,615,312,1101,s.s,206,409,1049,209,245,s.s,2272
CC Intercom Bernay Terres de Normandie,245,735,386,1366,225,732,369,1326,s.s,188,512,1287,236,337,s.s,2692
CC Intercom de la Vire Au Noireau,179,559,296,1034,145,561,309,1015,s.s,133,334,983,148,340,s.s,2049
CC Interrégionale Aumale - Blangy-Sur-Bresle,82,275,136,493,88,279,141,508,s.s,56,166,486,96,162,s.s,1001
CC Isigny-Omaha Intercom,77,263,140,480,77,317,137,531,s.s,79,197,461,67,134,s.s,1011
CC Isle Double Landais,65,191,108,364,53,197,122,372,s.s,45,125,393,58,82,s.s,736
CC Isle Vern Salembre en Périgord,65,259,144,468,61,242,142,445,s.s,87,201,408,52,101,s.s,913
CC Isle et Crempse en Périgord,34,201,115,350,38,182,117,337,s.s,71,142,307,41,68,s.s,687
CC Jabron-Lure-Vançon-Durance,18,70,32,120,22,84,51,157,28,34,78,113,11,13,",",277
CC Jalle-Eau-Bourde,89,325,110,524,53,372,142,567,s.s,180,249,358,35,37,s.s,1091
CC Jura Nord,37,100,72,209,20,98,53,171,s.s,51,75,167,24,33,s.s,380
CC Jura Sud,34,69,40,143,18,71,49,138,s.s,25,52,117,19,44,s.s,281
CC Lacs et Gorges du Verdon,43,167,108,318,34,168,130,332,s.s,58,141,298,47,60,s.s,650
CC Lamballe Terre et Mer,203,704,388,1295,167,688,358,1213,258,302,530,1090,125,188,15,2508
CC Larzac et Vallées,19,78,39,136,s.s,76,s.s,140,s.s,32,61,115,21,20,s.s,276
CC Latitude Nord Gironde,107,308,136,551,91,395,157,643,s.s,96,226,616,90,107,s.s,1194
CC Lauragais Revel Sorezois,89,295,181,565,76,356,173,605,s.s,126,285,470,78,81,s.s,1170
CC Lavalette Tude Dronne,51,220,102,373,53,194,126,373,s.s,79,152,343,57,63,s.s,746
CC Leff Armor Communauté,97,384,195,676,91,395,190,676,s.s,160,293,633,66,70,s.s,1352
CC Lieuvin Pays d'Auge,77,219,115,411,44,215,125,384,s.s,67,134,386,75,89,s.s,795
CC Liffré-Cormier Communauté,53,211,86,350,55,235,71,361,121,104,144,270,22,38,12,711
CC Loches Sud Touraine,203,601,368,1172,135,563,348,1046,194,171,444,1033,135,222,19,2218
CC Lodévois et Larzac,89,335,184,608,60,327,156,543,s.s,121,267,476,75,101,s.s,1151
CC Loir-Lucé-Bercé,99,263,174,536,83,284,180,547,s.s,91,189,512,81,151,s.s,1083
CC Loire Layon Aubance,158,506,243,907,133,500,237,870,234,257,376,678,106,111,15,1777
CC Loire et Allier,11,41,25,77,14,63,31,108,s.s,19,44,87,s.s,s.s,s.s,185
CC Loire et Semène,47,178,117,342,42,193,141,376,s.s,61,173,345,39,44,s.s,718
"CC Loire, Nièvre et Bertranges",75,239,124,438,55,170,114,339,s.s,64,172,369,55,76,s.s,777
"CC Loire, Vignobles et Nohain",102,306,159,567,68,288,186,542,s.s,77,226,546,88,112,s.s,1109
CC Lot et Tolzac,27,90,56,173,27,108,58,193,35,25,76,166,18,46,",",366
CC Loudéac Communauté - Bretagne Centre,179,645,290,1114,182,602,273,1057,s.s,186,468,981,172,218,s.s,2171
CC Loue-Lison,55,239,133,427,49,228,114,391,s.s,99,159,374,39,55,s.s,818
CC Loué - Brûlon - Noyen,53,172,85,310,49,169,87,305,s.s,52,125,287,30,69,s.s,615
CC Lyon Saint Exupéry en Dauphiné,106,400,167,673,81,449,153,683,s.s,146,275,549,106,189,s.s,1356
CC Lyons Andelle,86,246,120,452,63,286,135,484,s.s,81,183,415,84,121,s.s,936
CC Lèze Ariège,140,405,205,750,119,426,183,728,s.s,192,325,576,97,108,s.s,1478
CC Mad et Moselle,54,198,119,371,56,215,114,385,s.s,93,177,317,33,51,s.s,756
CC Maine Coeur de Sarthe,61,167,77,305,52,153,82,287,s.s,67,140,246,37,52,s.s,592
CC Maine Saosnois,115,346,176,637,93,348,181,622,s.s,81,238,615,104,168,s.s,1259
CC Maison de l'Intercommunalité de Haute Tarentaise,39,193,70,302,26,150,59,235,s.s,60,132,168,28,81,s.s,537
CC Marche Occitane - Val d'Anglin,19,73,52,144,18,58,47,123,s.s,23,53,134,21,19,s.s,267
CC Marches du Velay-Rochebaron,95,287,202,584,74,313,178,565,s.s,99,222,526,82,125,s.s,1149
CC Maremne Adour Côte Sud,289,1315,490,2094,236,1490,649,2375,649,725,1114,1629,154,188,10,4469
CC Maurienne Galibier,13,51,20,84,s.s,53,s.s,90,23,17,39,79,s.s,s.s,s.s,174
CC Mayenne Communauté,94,364,122,580,105,311,120,536,80,88,263,480,78,114,13,1116
"CC Meurthe, Mortagne, Moselle",66,200,90,356,58,191,109,358,45,66,141,347,56,59,",",714
CC Meuse Rognon,21,116,64,201,22,92,61,175,13,28,67,187,32,49,",",376
CC Midi Corrézien,33,151,89,273,22,152,88,262,67,73,133,207,25,30,",",535
CC Minervois Saint-Ponais Orb-Jaur,66,277,153,496,52,274,160,486,s.s,112,243,406,44,64,s.s,982
CC Mirebellois et Fontenois,24,113,56,193,16,105,42,163,s.s,43,67,151,18,27,s.s,356
CC Mond'arverne Communauté,93,413,195,701,68,382,179,629,s.s,180,259,520,66,87,s.s,1330
CC Mont Lozère,14,70,29,113,s.s,64,s.s,97,s.s,41,36,81,10,14,s.s,210
CC Montfort Communauté,89,210,85,384,44,205,82,331,s.s,114,143,256,35,41,s.s,715
CC Monts d'Arrée Communauté,21,117,72,210,28,93,61,182,s.s,55,107,145,26,16,s.s,392
"CC Monts, Rance et Rougier",12,83,48,143,10,67,47,124,33,31,61,109,12,21,",",267
CC Moret Seine et Loing,146,453,253,852,90,402,225,717,s.s,244,325,550,82,133,s.s,1569
CC Morvan Sommets et Grands Lacs,21,126,101,248,26,88,71,185,s.s,42,100,174,40,35,s.s,433
CC Moselle et Madon,98,333,184,615,74,232,106,412,s.s,112,196,458,64,87,s.s,1027
CC Moutierrois Talmondais,115,445,282,842,108,465,356,929,s.s,203,389,817,102,130,s.s,1771
CC Mâconnais - Tournugeois,57,220,96,373,48,169,93,310,s.s,63,121,305,51,89,s.s,683
CC Méditerranée Porte des Maures,245,864,428,1537,180,800,469,1449,s.s,334,713,1221,220,226,s.s,2986
CC Médoc Atlantique,151,606,307,1064,105,667,367,1139,s.s,257,497,924,142,171,s.s,2203
CC Médoc Coeur de Presqu'ile,160,521,252,933,172,646,314,1132,s.s,141,407,868,192,336,s.s,2065
CC Médoc Estuaire,88,312,127,527,87,398,178,663,100,154,245,510,60,111,10,1190
CC Médullienne,88,302,107,497,63,349,145,557,s.s,141,215,451,62,92,s.s,1054
CC Mézenc-Loire-Meygal,24,101,69,194,17,87,55,159,s.s,41,75,159,22,21,s.s,353
CC Nebbiu - Conca d'Oro,24,139,76,239,31,174,91,296,s.s,41,159,178,44,55,s.s,535
CC Neste Barousse,13,67,57,137,13,85,48,146,29,25,62,135,14,18,",",283
CC Nièvre et Somme,142,497,261,900,138,429,187,754,s.s,85,309,812,177,201,s.s,1654
CC Norge et Tille,36,92,54,182,13,113,67,193,s.s,77,66,129,13,15,s.s,375
CC Normandie-Cabourg-Pays d'Auge,133,399,211,743,106,367,209,682,s.s,150,274,635,91,129,s.s,1425
CC Océan Marais de Monts,76,302,170,548,68,318,204,590,s.s,111,276,508,65,80,s.s,1138
CC Orée de Bercé - Belinois,55,172,105,332,60,164,67,291,s.s,56,122,311,26,62,s.s,623
CC Osartis Marquion,165,483,258,906,130,541,257,928,115,209,462,785,104,144,15,1834
CC Ouche et Montagne,24,79,56,159,s.s,80,s.s,144,40,54,67,112,s.s,17,s.s,303
CC Ouest Limousin,30,124,72,226,23,115,85,223,s.s,50,99,188,30,47,s.s,449
CC Pays Créçois,99,340,186,625,85,375,165,625,193,172,318,398,79,78,12,1250
"CC Pays Dunois, Pays Sostranien, Bénévent/Grand-Bourg",86,261,189,536,40,210,136,386,57,72,171,483,53,86,",",922
CC Pays Forcalquier et Montagne de Lure,39,226,100,365,36,192,110,338,s.s,63,152,278,40,65,s.s,703
CC Pays Fort Sancerrois Val de Loire,57,191,127,375,54,208,123,385,s.s,57,152,365,50,79,s.s,760
CC Pays Rhin - Brisach,87,309,191,587,86,308,210,604,98,120,242,532,84,115,",",1191
CC Pays Ségali,42,132,68,242,24,155,75,254,s.s,66,103,221,20,26,s.s,496
CC Pays Vaison Ventoux (Copavo),63,247,151,461,57,285,192,534,s.s,118,215,394,81,94,s.s,995
CC Pays d'Apt-Luberon,142,593,298,1033,136,582,305,1023,216,214,465,781,132,236,12,2056
CC Pays d'Evian Vallée d'Abondance,110,565,272,947,84,582,241,907,s.s,224,385,740,92,135,s.s,1854
CC Pays d'Opale,155,340,184,679,136,428,184,748,s.s,135,309,646,81,173,s.s,1427
CC Pays d'Orthe et Arrigans,85,307,192,584,66,345,164,575,99,124,265,526,65,80,",",1159
CC Pays d'Uzès,131,515,235,881,99,512,271,882,s.s,232,384,675,118,135,s.s,1763
"CC Pays de Boussac, Carrefour des Quatre Provinces, Evaux-Les-Bains/Chambon-Sur-Voueize",56,180,158,394,38,174,126,338,s.s,65,147,360,37,67,s.s,732
CC Pays de Chantonnay,74,175,95,344,77,241,105,423,s.s,75,138,361,61,79,s.s,767
CC Pays de Coulommiers,188,582,275,1045,144,631,255,1030,s.s,216,509,836,156,185,s.s,2075
CC Pays de Fontenay-Vendée,142,539,254,935,122,463,268,853,s.s,139,339,875,146,171,s.s,1788
CC Pays de L?audunois et du Bassin de Landres,77,296,146,519,60,348,210,618,s.s,79,242,606,55,94,s.s,1137
CC Pays de Montereau,196,769,328,1293,170,825,281,1276,s.s,214,535,1020,188,394,s.s,2569
CC Pays de Nay,70,245,129,444,43,289,176,508,s.s,119,208,391,44,70,s.s,952
CC Pays de Nemours,114,428,210,752,108,426,187,721,s.s,151,301,542,124,229,s.s,1473
CC Pays de Nexon Monts de Chalus,32,129,70,231,24,127,55,206,s.s,39,84,209,28,32,s.s,437
CC Pays de Nérondes,15,68,47,130,17,62,38,117,s.s,14,45,134,23,24,s.s,247
CC Pays des Vans en Cévennes,42,230,159,431,34,228,114,376,s.s,107,192,311,49,49,s.s,807
CC Pays du Mont-Blanc,106,473,174,753,89,399,194,682,197,188,299,515,97,123,16,1435
CC Perthois-Bocage et Der,17,51,28,96,10,64,39,113,11,22,41,93,15,27,",",209
CC Petite Montagne,17,64,40,121,15,56,26,97,19,11,40,102,23,23,",",218
CC Picardie des Châteaux,96,280,155,531,76,259,117,452,s.s,76,185,471,96,99,s.s,983
CC Piège Lauragais Malepère,67,203,123,393,60,270,134,464,s.s,104,225,348,53,52,s.s,857
CC Plaine Limagne,62,289,149,500,49,273,140,462,70,70,184,419,71,148,",",962
CC Plaines et Monts de France,79,216,99,394,67,234,99,400,s.s,110,197,296,55,51,s.s,794
CC Plateau de Caux-Doudeville-Yerville,80,201,98,379,69,221,108,398,42,66,165,368,52,84,",",777
CC Pleyben-Châteaulin-Porzay,76,267,138,481,68,273,157,498,s.s,113,243,409,56,49,s.s,979
CC Poher Communauté,70,192,102,364,52,169,102,323,s.s,61,151,309,51,60,s.s,687
CC Ponthieu-Marquenterre,176,473,212,861,150,447,202,799,s.s,135,346,749,157,189,s.s,1660
CC Pontivy Communauté,188,590,272,1050,140,526,271,937,166,224,461,810,128,182,16,1987
CC Porte Océane du Limousin,90,281,174,545,86,278,151,515,s.s,78,216,503,66,130,s.s,1060
CC Porte d'Alsace - Largue,73,215,187,475,70,217,153,440,s.s,71,165,449,65,94,s.s,915
CC Porte d'Aquitaine en Pays de Serres,19,56,28,103,13,70,36,119,22,21,50,104,12,13,",",222
CC Porte de Dromardèche,211,667,359,1237,173,796,353,1322,158,226,492,1063,209,399,12,2559
CC Porte de Maurienne,19,53,39,111,22,81,39,142,s.s,25,55,108,19,23,s.s,253
CC Porte du Jura,33,111,46,190,29,81,55,165,s.s,34,62,170,24,38,s.s,355
CC Portes de la Creuse en Marche,15,73,48,136,18,63,66,147,s.s,18,61,142,14,33,s.s,283
CC Portes du Berry Entre Loire et Val d'Aubois,33,115,69,217,20,144,79,243,s.s,29,95,226,41,53,s.s,460
CC Presqu'île de Crozon-Aulne Maritime,82,332,186,600,74,316,187,577,s.s,150,271,492,51,51,s.s,1177
CC Provence Verdon,99,312,201,612,82,392,193,667,118,121,277,570,92,91,10,1279
CC Pré-Bocage Intercom,69,221,137,427,74,281,102,457,s.s,73,176,403,48,102,s.s,884
CC Pyrénées Audoises,59,270,161,490,57,229,190,476,s.s,85,211,421,56,88,s.s,966
CC Pyrénées Cerdagne,31,114,52,197,25,100,59,184,s.s,42,81,150,35,32,s.s,381
CC Pyrénées Haut Garonnaises,48,205,124,377,26,187,145,358,s.s,64,153,353,57,43,s.s,735
CC Pyrénées Vallées des Gaves,46,203,120,369,43,247,172,462,s.s,93,194,346,34,45,s.s,831
CC Pévèle-Carembault,319,1023,509,1851,230,1008,447,1685,570,507,795,1201,205,235,23,3536
CC Quercy - Bouriane,30,137,105,272,29,126,111,266,s.s,53,135,222,38,49,s.s,538
CC Quercy Vert-Aveyron,96,312,125,533,85,381,158,624,s.s,117,239,498,64,134,s.s,1157
CC Questembert Communauté,47,256,141,444,54,320,152,526,s.s,122,217,427,39,53,s.s,970
CC Rahin et Cherimont,57,143,99,299,46,141,81,268,s.s,53,100,233,61,78,s.s,567
CC Randon - Margeride,16,33,15,64,s.s,39,s.s,62,11,25,34,38,s.s,15,s.s,126
CC Retz en Valois,126,474,223,823,114,485,237,836,s.s,135,321,745,131,229,s.s,1659
"CC Rhony, Vistre, Vidourle",111,409,203,723,105,463,231,799,s.s,209,352,600,81,94,s.s,1522
CC Rhône Crussol,112,341,169,622,77,420,236,733,s.s,199,273,538,70,94,s.s,1355
CC Rhône Lez Provence,138,498,233,869,130,526,260,916,s.s,144,336,796,130,278,s.s,1785
CC Riom Limagne et Volcans,211,770,351,1332,163,765,415,1343,s.s,301,522,1072,170,289,s.s,2675
CC Rives de Moselle,174,744,401,1319,190,752,408,1350,s.s,285,567,1139,153,273,s.s,2669
"CC Rives de Saône, Cc Saint Jean de Losne Seurre",66,209,140,415,46,241,125,412,s.s,54,164,394,47,120,s.s,827
CC Rives de l'Ain - Pays du Cerdon,47,171,88,306,43,165,82,290,s.s,71,124,268,31,53,s.s,596
CC Roi Morvan Communauté,84,305,218,607,63,288,196,547,s.s,104,248,523,79,94,s.s,1154
CC Roumois Seine,166,498,262,926,126,580,264,970,130,200,443,863,82,165,13,1896
CC Roussillon-Conflent,92,488,211,791,100,448,175,723,s.s,125,266,621,176,223,s.s,1514
CC Rurales de l'Entre-Deux-Mers,69,220,119,408,42,265,127,434,s.s,84,166,371,50,105,s.s,842
"CC Région Lézignanaise, Corbières et Minervois",193,622,312,1127,156,562,324,1042,156,197,444,1002,156,197,17,2169
"CC Saint Affricain, Roquefort, Sept Vallons",45,199,93,337,39,172,100,311,s.s,90,128,253,55,55,s.s,648
CC Saint Cyr Mère Boitier Entre Charolais et Mâconnais,12,73,37,122,10,56,29,95,s.s,33,45,89,s.s,18,s.s,217
CC Saint-Pourçain Sioule Limagne,117,413,232,762,107,402,241,750,s.s,122,288,733,123,140,s.s,1512
CC Sarlat-Périgord Noir,87,293,189,569,66,331,185,582,s.s,120,248,475,71,124,s.s,1151
CC Sarrebourg Moselle Sud,163,474,315,952,155,512,270,937,117,151,362,864,158,220,17,1889
CC Sauer-Pechelbronn,42,150,100,292,48,131,118,297,s.s,46,115,292,25,69,s.s,589
CC Sauldre et Sologne,53,173,106,332,47,150,107,304,s.s,49,114,306,50,88,s.s,636
CC Sausseron Impressionnistes,50,184,124,358,37,214,127,378,s.s,112,179,229,31,45,s.s,736
CC Save Garonne et Côteaux de Cadours,117,404,174,695,90,487,176,753,s.s,199,362,536,72,94,s.s,1448
CC Saône Doubs Bresse,36,99,62,197,28,137,74,239,34,42,80,208,30,42,",",436
CC Saône-Beaujolais,136,414,215,765,135,509,238,882,s.s,165,373,670,97,175,s.s,1647
CC Seine et Aube,37,119,80,236,35,145,79,259,s.s,38,78,264,41,51,s.s,495
CC Senlis Sud Oise,64,272,174,510,61,305,139,505,s.s,141,201,301,73,80,s.s,1015
CC Serein et Armance,89,327,170,586,88,282,193,563,s.s,70,207,550,76,187,s.s,1149
CC Serre-Ponçon,60,283,121,464,44,251,122,417,s.s,120,218,332,47,42,s.s,881
CC Serre-Ponçon Val d'Avance,24,113,54,191,29,88,54,171,s.s,37,69,165,31,15,s.s,362
CC Seulles Terre et Mer,53,170,60,283,33,138,82,253,s.s,73,117,214,22,47,s.s,536
CC Sidobre Val d'Agout-Vals et Plateaux des Monts de Lacaune,28,157,93,278,36,163,94,293,s.s,72,119,241,45,46,s.s,571
CC Somme Sud-Ouest,174,461,259,894,130,458,224,812,s.s,124,314,762,204,215,s.s,1706
CC Sud Côte Chalonnaise,28,124,59,211,24,105,65,194,46,55,81,169,28,26,",",405
CC Sud Nivernais,61,233,160,454,65,191,140,396,s.s,70,138,467,56,88,s.s,850
CC Sud Retz Atlantique,104,329,185,618,89,350,179,618,95,127,252,585,60,106,11,1236
CC Sud Sarthe,117,293,214,624,96,354,168,618,s.s,105,204,626,94,153,s.s,1242
CC Sud Vendée Littoral,209,735,425,1369,182,752,436,1370,s.s,243,522,1405,165,250,s.s,2739
CC Sud-Hérault,81,325,137,543,84,335,174,593,s.s,105,261,524,73,87,s.s,1136
CC Sud-Roussillon,138,550,302,990,131,569,344,1044,s.s,197,464,866,180,158,s.s,2034
CC Sumène - Artense,18,71,36,125,23,68,48,139,s.s,25,54,123,22,26,s.s,264
CC Sèvre et Loire,126,410,213,749,118,449,216,783,160,240,367,589,67,87,22,1532
CC Tannay-Brinon-Corbigny,24,88,65,177,21,82,67,170,20,27,64,180,27,29,",",347
CC Tarn-Agout,89,314,201,604,86,405,172,663,s.s,172,301,483,70,74,s.s,1267
CC Terre Lorraine du Longuyonnais,47,179,114,340,43,159,99,301,s.s,43,119,316,53,65,s.s,641
CC Terre d'Eau,64,258,159,481,68,283,156,507,s.s,82,169,465,83,120,s.s,988
CC Terre de Camargue,165,603,292,1060,120,558,328,1006,165,196,460,872,179,181,13,2066
CC Terre de Picardie,102,298,123,523,92,261,135,488,s.s,56,168,464,112,167,s.s,1011
CC Terres Touloises,168,605,274,1047,139,570,247,956,130,195,392,911,138,227,10,2003
CC Terres de Bresse,73,179,130,382,50,245,146,441,s.s,81,149,378,59,97,s.s,823
CC Terres de Chalosse,54,185,127,366,55,235,143,433,s.s,90,186,385,33,45,s.s,799
"CC Terres de Montaigu, Cc Montaigu-Rocheservière",133,405,170,708,98,432,175,705,171,180,314,556,65,109,18,1413
CC Terres de Perche,63,225,119,407,57,231,113,401,s.s,51,154,374,101,92,s.s,808
CC Terres de Saône,43,145,71,259,35,112,70,217,26,34,86,243,38,49,",",476
CC Terres des Confluences,240,1103,372,1715,257,1048,363,1668,162,216,575,1132,322,954,22,3383
CC Terres du Haut Berry,81,291,137,509,58,252,129,439,s.s,94,198,427,65,88,s.s,948
CC Territoriale Sud-Luberon,111,395,198,704,90,422,199,711,s.s,185,298,545,73,110,s.s,1415
CC Terroir de Caux,136,327,206,669,131,390,216,737,s.s,108,306,642,105,168,s.s,1406
CC Thiers Dore et Montagne,165,653,398,1216,149,613,381,1143,s.s,166,405,1073,221,351,s.s,2359
CC Thiérache Sambre et Oise,121,420,182,723,126,347,156,629,s.s,59,198,632,154,277,s.s,1352
CC Tille et Venelle,16,49,27,92,14,47,20,81,s.s,16,38,74,16,13,s.s,173
CC Touraine Ouest Val de Loire,130,393,211,734,119,438,233,790,100,148,279,704,116,165,12,1524
CC Touraine Val de Vienne,81,323,202,606,65,273,180,518,s.s,79,192,569,85,118,s.s,1124
CC Touraine Vallée de l'Indre,153,447,247,847,120,495,241,856,s.s,221,377,695,87,100,s.s,1703
CC Touraine-Est Vallées,121,352,160,633,79,373,169,621,s.s,183,286,489,53,72,s.s,1254
CC Usses et Rhône,29,237,111,377,46,254,103,403,s.s,85,173,340,47,41,s.s,780
CC Val 81,23,50,36,109,13,59,36,108,23,15,49,96,14,20,",",217
CC Val Briard,107,321,165,593,81,367,171,619,s.s,195,279,453,70,63,s.s,1212
CC Val Eyrieux,35,116,103,254,25,102,129,256,s.s,45,120,213,38,51,s.s,510
CC Val Guiers,31,148,76,255,29,159,86,274,s.s,49,112,236,32,33,s.s,529
CC Val Vanoise Tarentaise,15,78,27,120,14,71,42,127,s.s,33,58,83,12,19,s.s,247
CC Val de Charente,74,236,115,425,54,183,112,349,s.s,35,140,377,65,117,s.s,774
CC Val de Gers,22,92,55,169,21,65,47,133,30,40,70,124,19,19,",",302
CC Val de Gray,100,250,138,488,97,247,152,496,59,54,181,495,73,122,",",984
CC Val de Gâtine,52,210,119,381,51,227,100,378,s.s,77,163,382,30,56,s.s,759
CC Val de Ligne,31,154,77,262,26,118,79,223,s.s,54,123,182,30,42,s.s,485
CC Val de Meuse - Voie Sacrée,40,99,49,188,17,100,39,156,s.s,25,77,175,21,26,s.s,344
CC Val de Saône Centre,45,144,70,259,41,167,102,310,s.s,69,132,232,34,44,s.s,569
CC Val de l'Indre - Brenne,56,147,101,304,44,147,93,284,26,52,102,292,45,71,",",588
CC Val Ès Dunes,74,186,82,342,54,191,84,329,s.s,65,153,298,42,59,s.s,671
CC Val'aïgo,66,194,95,355,51,258,96,405,s.s,92,160,300,47,65,s.s,760
CC Val-De-Cher-Controis,185,611,305,1101,147,513,285,945,125,183,346,977,168,234,13,2046
CC Vallons de Haute-Bretagne Communauté,114,397,193,704,93,443,203,739,s.s,201,344,591,74,75,s.s,1443
CC Vallée de l'Ubaye - Serre-Ponçon,27,111,75,213,20,97,58,175,s.s,49,98,149,25,18,s.s,388
CC Vallée de l'hérault,169,724,342,1235,146,785,331,1262,s.s,317,571,984,137,139,s.s,2497
CC Vallée de la Dordogne et Forêt Bessède,34,143,72,249,32,140,77,249,s.s,48,113,215,27,58,s.s,498
CC Vallée des Baux-Alpilles (Cc Vba),106,387,223,716,99,450,259,808,s.s,208,354,544,76,133,s.s,1524
CC Vallées de l'Orne et de l'Odon,67,208,93,368,50,215,91,356,99,82,164,276,29,64,10,724
CC Vallées et Plateau d'Ardenne,125,349,227,701,94,357,204,655,s.s,84,226,653,138,203,s.s,1356
CC Vals de Saintonge,211,787,395,1393,181,753,441,1375,s.s,234,512,1405,190,261,s.s,2768
"CC Vendée, Sèvre, Autise",55,165,101,321,45,205,106,356,42,76,165,311,40,43,",",677
CC Ventoux Sud,55,162,83,300,40,172,86,298,s.s,60,136,254,39,68,s.s,598
CC Vexin Centre,81,250,145,476,64,261,129,454,s.s,150,235,323,36,42,s.s,930
CC Vienne et Gartempe,127,388,230,745,92,350,235,677,s.s,113,282,719,83,131,s.s,1422
CC Vierzon-Sologne-Berry,179,806,401,1386,155,631,296,1082,s.s,172,422,1186,159,413,s.s,2468
CC Vézère-Monédières-Millesources,s.s,38,s.s,80,s.s,35,s.s,74,s.s,s.s,41,58,16,s.s,s.s,154
CC Xaintrie Val'dordogne,35,121,79,235,26,111,70,207,s.s,41,84,202,34,38,s.s,442
CC Yonne Nord,108,288,148,544,72,294,152,518,s.s,104,211,518,64,93,s.s,1062
CC d'Aire Sur l'Adour,45,145,78,268,35,139,82,256,34,45,111,228,28,78,",",524
CC d'Altkirch et Environs,137,527,393,1057,118,497,319,934,s.s,215,374,917,104,221,s.s,1991
"CC d'Arcis, Mailly, Ramerupt",50,136,75,261,35,176,77,288,s.s,43,90,269,53,67,s.s,549
CC d'Auberive Vingeanne et Montsaugeonnais,24,63,51,138,20,84,46,150,s.s,27,55,134,26,23,s.s,288
CC d'Erdre et Gesvres,194,558,223,975,138,641,213,992,373,321,443,687,58,74,11,1967
CC de Bayeux Intercom,126,460,203,789,104,463,187,754,s.s,145,299,671,102,168,s.s,1543
CC de Belle Ile en Mer,26,111,54,191,23,134,68,225,s.s,47,112,155,25,24,s.s,416
CC de Bièvre Est,63,205,109,377,56,262,113,431,s.s,104,173,330,45,69,s.s,808
CC de Blavet Bellevue Océan,46,166,83,295,40,198,146,384,s.s,84,166,285,26,44,s.s,679
CC de Blaye,127,368,164,659,107,386,180,673,s.s,81,265,657,100,154,s.s,1332
CC de Bléré Val de Cher,65,213,115,393,63,238,120,421,76,90,173,358,39,67,11,814
CC de Brocéliande,27,171,81,279,35,207,64,306,s.s,95,129,213,29,31,s.s,585
CC de Calvi Balagne,83,345,169,597,104,570,195,869,151,146,389,459,147,163,11,1466
CC de Cambremer,14,61,36,111,11,56,34,101,25,32,34,80,18,23,",",212
CC de Cattenom et Environs,56,229,103,388,45,256,116,417,s.s,124,174,300,25,45,s.s,805
CC de Charente Limousine,116,405,218,739,74,382,227,683,s.s,87,278,697,111,173,s.s,1422
CC de Commercy - Void - Vaucouleurs,93,347,174,614,80,350,180,610,s.s,89,228,617,89,145,s.s,1224
CC de Cèze Cévennes,114,489,267,870,94,411,277,782,s.s,124,370,738,150,170,s.s,1652
CC de Damvillers Spincourt,32,105,57,194,17,120,56,193,s.s,28,51,239,18,34,s.s,387
CC de Desvres-Samer,92,302,122,516,90,356,151,597,s.s,106,261,491,81,111,s.s,1113
CC de Domme- Villefranche du Périgord,30,127,78,235,27,116,86,229,s.s,62,103,202,23,37,s.s,464
CC de Fium'orbu Castellu,54,239,120,413,64,302,141,507,s.s,69,205,326,90,140,s.s,920
CC de Flandre Intérieure,344,1166,541,2051,313,1119,546,1978,324,408,874,1667,273,471,12,4029
CC de Forez-Est,171,539,299,1009,187,599,348,1134,188,223,472,945,124,179,12,2143
CC de Freyming-Merlebach,192,748,306,1246,139,629,312,1080,s.s,172,425,1121,188,331,s.s,2326
CC de Gevrey-Chambertin et de Nuits-Saint-Georges,59,261,142,462,55,250,136,441,s.s,99,172,400,52,65,s.s,903
CC de Grand Lieu,116,329,140,585,83,397,138,618,153,156,260,512,43,61,18,1203
"CC de Granville, Terre et Mer",172,526,309,1007,139,511,306,956,184,204,428,842,130,164,11,1963
CC de Gâtine et Choisilles - Pays de Racan,70,187,104,361,34,218,110,362,s.s,89,163,319,35,56,s.s,723
CC de Gémozac et de la Saintonge Viticole,60,177,114,351,55,208,112,375,s.s,81,149,355,51,55,s.s,726
CC de Hanau- la Petite Pierre,74,255,157,486,82,258,141,481,s.s,89,173,459,78,99,s.s,967
CC de Haute Cornouaille,59,165,124,348,42,176,108,326,s.s,54,164,304,42,50,s.s,674
CC de Lacq-Orthez,161,563,345,1069,150,619,328,1097,s.s,267,450,1026,92,132,s.s,2166
CC de Londinières,20,67,32,119,25,63,24,112,s.s,20,46,108,15,29,s.s,231
CC de Lévézou Pareloup,s.s,29,s.s,47,14,34,30,78,s.s,14,28,55,s.s,s.s,s.s,125
CC de Marana-Golo,100,344,143,587,92,510,196,798,s.s,132,354,542,87,138,s.s,1385
CC de Marie-Galante,84,337,234,655,63,355,242,660,35,64,223,597,114,282,",",1315
CC de Millau Grands Causses,168,553,231,952,110,484,238,832,s.s,196,422,702,108,157,s.s,1784
CC de Mimizan,63,255,85,403,57,279,144,480,s.s,87,219,401,40,69,s.s,883
CC de Mirecourt Dompaire,60,235,118,413,49,219,117,385,s.s,47,160,379,59,103,s.s,798
CC de Miribel et du Plateau,47,234,109,390,56,229,119,404,s.s,103,177,271,42,76,s.s,794
CC de Montaigne Montravel et Gurson,45,182,88,315,45,205,99,349,s.s,63,111,305,55,87,s.s,664
CC de Montbenoit,11,55,41,107,14,61,38,113,17,22,45,110,11,15,",",220
CC de Montesquieu,152,435,202,789,96,512,220,828,s.s,260,342,597,74,80,s.s,1617
CC de Noblat,29,156,83,268,35,128,73,236,62,49,104,219,35,35,",",504
CC de Parthenay-Gâtine,131,423,232,786,107,392,234,733,s.s,140,282,736,85,150,s.s,1519
CC de Petite Camargue,151,593,274,1018,122,617,262,1001,120,175,390,817,206,299,12,2019
CC de Ploërmel Communauté,132,479,229,840,110,439,243,792,s.s,157,364,721,99,123,s.s,1632
"CC de Podensac, des Coteaux de Garonne et de Lestiac-Sur-Garonne,paillet,rions",109,497,200,806,88,506,219,813,s.s,179,327,683,83,195,s.s,1619
CC de Pont-Audemer / Val de Risle,145,416,209,770,114,445,218,777,s.s,122,289,751,120,183,s.s,1547
CC de Portes Sud Périgord,23,94,58,175,22,100,65,187,32,41,90,143,26,30,",",362
CC de Pouilly en Auxois/Bligny Sur Ouche,24,77,52,153,26,79,60,165,s.s,36,53,151,18,30,s.s,318
CC de Puisaye-Forterre,111,420,256,787,89,389,249,727,s.s,121,266,746,109,158,s.s,1514
CC de Sablé-Sur-Sarthe,115,350,157,622,119,368,151,638,70,92,242,565,104,177,10,1260
CC de Saint-Méen Montauban,70,226,108,404,50,254,107,411,s.s,105,176,353,42,63,s.s,815
CC de Saulieu,21,79,62,162,16,54,44,114,10,18,46,142,17,43,",",276
CC de Saverne-Marmoutier-Sommerau,110,414,228,752,98,449,212,759,s.s,142,309,614,104,184,s.s,1511
CC de Seille et Mauchère ? Grand Couronné,65,154,91,310,43,162,71,276,s.s,69,143,250,25,23,s.s,586
CC de Suippe et Vesle,25,44,32,101,15,93,22,130,s.s,19,39,123,18,21,s.s,231
CC de Sélestat,147,508,257,912,141,535,248,924,173,169,340,740,165,236,13,1836
CC de Sézanne-Sud Ouest Marnais,81,247,133,461,64,280,157,501,s.s,74,190,469,71,107,s.s,962
CC de Vendeuvre-Soulaines,36,107,68,211,16,103,58,177,s.s,25,46,190,43,65,s.s,388
CC de Ventadour - Egletons - Monédières,32,104,64,200,24,105,71,200,25,42,84,164,30,55,",",400
CC de Vezouze en Piémont,47,185,135,367,30,150,105,285,s.s,43,100,319,46,111,s.s,652
CC de Vie et Boulogne,132,378,192,702,101,464,228,793,s.s,169,347,662,81,108,s.s,1495
CC de Villedieu Intercom,40,184,105,329,29,174,86,289,s.s,51,99,339,39,62,s.s,618
"CC de Vitry, Champagne et Der",98,414,182,694,82,359,197,638,s.s,106,217,652,114,189,s.s,1332
CC de Yenne,16,70,37,123,21,84,35,140,s.s,28,56,129,s.s,s.s,s.s,263
CC de l'Agglomération Migennoise,88,224,105,417,60,214,99,373,s.s,54,98,400,59,136,s.s,790
CC de l'Aillantais,32,100,54,186,23,74,63,160,s.s,42,67,154,18,28,s.s,346
CC de l'Aire Cantilienne,110,501,265,876,81,529,278,888,422,291,384,472,73,107,15,1764
CC de l'Alsace Bossue,67,256,177,500,74,259,171,504,s.s,74,185,506,79,107,s.s,1004
CC de l'Alta Rocca,41,177,75,293,27,220,100,347,s.s,68,153,213,53,96,s.s,640
CC de l'Arc Mosellan,112,318,174,604,69,343,196,608,s.s,131,249,544,75,85,s.s,1212
CC de l'Argonne Ardennaise,54,200,116,370,44,199,88,331,s.s,52,126,341,44,100,s.s,701
CC de l'Argonne Champenoise,49,158,84,291,30,163,58,251,s.s,42,102,247,45,67,s.s,542
CC de l'Ernée,66,150,77,293,40,156,71,267,s.s,49,101,273,31,56,s.s,560
CC de l'Est Guyanais,78,235,81,394,70,267,61,398,s.s,10,53,207,157,353,s.s,792
CC de l'Est Lyonnais (Ccel),103,347,167,617,84,394,197,675,s.s,185,262,452,61,78,s.s,1292
CC de l'Est de la Somme,130,370,155,655,98,341,183,622,s.s,76,232,624,108,191,s.s,1277
CC de l'Estuaire - Canton de Saint Ciers Sur Gironde,90,288,114,492,70,340,159,569,s.s,68,201,544,84,128,s.s,1061
CC de l'Ile d'Oléron,125,481,201,807,113,460,286,859,s.s,202,397,727,88,94,s.s,1666
CC de l'Ile de Noirmoutier,39,140,87,266,37,150,106,293,s.s,63,152,228,31,33,s.s,559
CC de l'Ile de Ré,104,323,152,579,84,360,190,634,s.s,178,315,430,59,54,s.s,1213
CC de l'Ile-Rousse - Balagne,73,227,108,408,69,320,120,509,s.s,81,233,309,92,100,s.s,917
CC de l'Oisans,32,129,63,224,27,89,52,168,s.s,41,101,146,25,25,s.s,392
CC de l'Oise Picarde,162,395,198,755,127,370,128,625,s.s,96,256,697,124,136,s.s,1380
CC de l'Oriente,12,96,47,155,27,100,60,187,s.s,33,73,119,35,60,s.s,342
CC de l'Orvin et de l'Ardusson,27,113,49,189,28,135,64,227,16,24,74,207,42,53,",",416
CC de l'Ouest Corse,38,195,99,332,32,166,96,294,s.s,50,147,214,65,83,s.s,626
CC de l'Ouest Guyanais,372,1421,488,2281,495,1960,421,2876,82,106,705,1647,488,2097,32,5157
CC de l'Ouest Vosgien,83,343,216,642,88,257,179,524,s.s,94,214,532,110,159,s.s,1166
CC de l'Oust À Brocéliande Communauté,100,395,187,682,79,420,196,695,124,170,323,578,82,89,11,1377
CC de l'Outre-Forêt,41,125,108,274,51,175,100,326,41,47,97,301,35,79,",",600
CC de la Baie du Cotentin,93,280,155,528,81,243,127,451,s.s,76,165,508,56,122,s.s,979
CC de la Basse-Zorn,32,129,89,250,39,123,74,236,47,51,96,230,22,40,",",486
CC de la Beauce Loirétaine,51,118,68,237,36,142,69,247,s.s,42,96,214,32,46,s.s,484
CC de la Brie Champenoise,26,95,53,174,15,107,48,170,s.s,14,63,170,26,62,s.s,344
CC de la Castagniccia-Casinca,52,188,109,349,61,261,130,452,s.s,65,169,309,95,92,s.s,801
CC de la Champagne Conlinoise et du Pays de Sillé,74,194,92,360,78,201,95,374,s.s,60,127,355,63,76,s.s,734
CC de la Champagne Picarde,88,262,162,512,77,268,138,483,s.s,73,187,450,94,141,s.s,995
CC de la Châtaigneraie Cantalienne,27,179,89,295,34,133,97,264,s.s,56,119,254,39,43,s.s,559
CC de la Châtre et Sainte Sévère,67,201,128,396,36,166,117,319,s.s,44,147,326,65,82,s.s,715
"CC de la Cléry, du Betz et de l'Ouanne",87,298,157,542,63,263,156,482,s.s,76,191,492,85,109,s.s,1024
CC de la Costa Verde,50,180,86,316,42,190,119,351,s.s,50,146,273,67,85,s.s,667
CC de la Côtière À Montluel,79,221,115,415,49,243,114,406,s.s,109,183,309,46,70,s.s,821
CC de la Dombes,93,305,162,560,89,358,189,636,s.s,146,258,498,65,90,s.s,1196
CC de la Forêt,51,129,60,240,45,142,71,258,s.s,56,108,213,31,47,s.s,498
CC de la Gascogne Toulousaine,50,180,98,328,45,230,105,380,s.s,125,155,243,23,40,s.s,708
CC de la Grande Vallée de la Marne,58,140,76,274,33,129,75,237,s.s,54,94,226,34,64,s.s,511
CC de la Haute Ariège,26,99,60,185,13,93,68,174,s.s,39,79,157,19,30,s.s,359
CC de la Haute Comté,55,253,124,432,65,250,156,471,s.s,66,162,409,69,151,s.s,903
CC de la Haute Deûle,103,322,138,563,82,293,137,512,s.s,119,255,449,63,99,s.s,1075
CC de la Haute Saintonge,278,930,467,1675,203,988,570,1761,185,255,659,1719,243,364,11,3436
CC de la Haute Somme,142,520,256,918,150,464,278,892,s.s,116,339,811,198,292,s.s,1810
CC de la Haute Vallée de Chevreuse,28,212,129,369,33,196,98,327,s.s,123,131,133,21,27,s.s,696
CC de la Haute Vallée de l'Ognon,31,107,66,204,26,98,79,203,s.s,35,70,185,35,55,s.s,407
CC de la Haute Vallée de la Gravona,39,154,63,256,40,124,63,227,s.s,50,114,205,47,23,s.s,483
CC de la Haute-Bigorre,67,225,176,468,40,228,172,440,s.s,98,188,400,43,70,s.s,908
CC de la Lomagne Gersoise,50,227,149,426,61,229,147,437,s.s,94,179,351,73,81,s.s,863
CC de la Lomagne Tarn-Et-Garonnaise,37,142,66,245,26,129,60,215,s.s,35,76,187,47,66,s.s,460
CC de la Marche Berrichonne,s.s,46,s.s,93,s.s,41,s.s,82,s.s,15,39,86,10,10,s.s,175
CC de la Matheysine,65,235,127,427,43,225,113,381,s.s,75,180,349,53,64,s.s,808
CC de la Moivre À la Coole,25,54,28,107,21,72,36,129,s.s,30,51,106,10,18,s.s,236
CC de la Montagne Noire,14,91,69,174,21,91,71,183,32,27,76,181,28,13,",",357
CC de la Montagne d'Ardèche,11,42,35,88,s.s,55,s.s,97,18,13,43,84,s.s,14,s.s,185
CC de la Mossig et du Vignoble,62,204,106,372,64,230,107,401,s.s,92,161,333,39,61,s.s,773
CC de la Muse et des Raspes du Tarn,12,52,43,107,s.s,66,s.s,106,23,36,60,79,s.s,s.s,s.s,213
CC de la Picardie Verte,163,410,216,789,119,422,186,727,s.s,83,278,749,164,171,s.s,1516
CC de la Pieve de l'Ornano,44,193,116,353,33,228,116,377,s.s,84,193,253,52,62,s.s,730
CC de la Plaine Dijonnaise,59,186,101,346,42,200,120,362,s.s,72,140,339,41,64,s.s,708
CC de la Plaine Jurassienne,27,73,52,152,18,76,46,140,s.s,16,53,149,22,35,s.s,292
CC de la Plaine d'Estrées,55,150,88,293,52,189,87,328,52,83,131,267,37,51,",",621
CC de la Plaine de l'Ain,261,870,407,1538,238,1004,451,1693,274,357,664,1370,215,325,26,3231
CC de la Plaine du Nord Loiret,23,60,39,122,17,72,34,123,s.s,25,52,104,14,24,s.s,245
CC de la Plaine du Rhin,35,116,145,296,34,142,116,292,s.s,52,107,276,29,64,s.s,588
CC de la Porte des Vosges Méridionales,104,485,283,872,92,372,251,715,s.s,140,295,736,131,175,s.s,1587
CC de la Région d'Audruicq,130,328,153,611,106,428,186,720,s.s,123,292,612,82,135,s.s,1331
CC de la Région d'Orgelet,13,48,24,85,s.s,48,s.s,81,18,18,38,73,s.s,10,s.s,166
CC de la Région d'Yvetot,116,328,151,595,87,328,135,550,s.s,97,227,498,81,150,s.s,1145
CC de la Région de Bar Sur Aube,67,188,108,363,63,178,89,330,s.s,41,97,304,79,131,s.s,693
CC de la Région de Blain,42,148,68,258,46,180,61,287,54,50,135,242,27,37,",",545
CC de la Région de Condrieu,48,151,91,290,44,165,82,291,s.s,82,120,217,32,43,s.s,581
CC de la Région de Guebwiller,131,520,281,932,128,491,271,890,s.s,167,345,842,129,188,s.s,1822
CC de la Région de Levroux,15,96,43,154,16,80,33,129,11,22,46,157,20,27,",",283
CC de la Région de Molsheim-Mutzig,153,385,178,716,107,404,155,666,s.s,178,293,580,66,117,s.s,1382
CC de la Région de Nozay,46,145,72,263,39,163,59,261,s.s,71,113,232,26,32,s.s,524
CC de la Région de Rambervillers,67,188,127,382,60,178,113,351,s.s,54,133,340,83,96,s.s,733
CC de la Save Au Touch,124,441,198,763,105,594,198,897,285,247,397,547,74,100,10,1660
CC de la Sologne des Etangs,17,73,47,137,20,79,61,160,s.s,34,43,140,23,32,s.s,297
CC de la Sologne des Rivières,23,139,91,253,19,134,83,236,s.s,34,79,239,47,61,s.s,489
CC de la Station des Rousses-Haut Jura,17,104,51,172,18,96,47,161,s.s,44,81,129,13,14,s.s,333
CC de la Tenarèze,62,162,113,337,52,165,109,326,56,64,131,283,54,75,",",663
CC de la Terre des Deux Caps,104,320,139,563,96,337,151,584,s.s,107,272,485,79,117,s.s,1147
CC de la Thiérache du Centre,165,472,221,858,157,478,196,831,s.s,119,306,785,181,247,s.s,1689
CC de la Vallée Verte,12,92,42,146,14,84,38,136,s.s,37,61,109,14,18,s.s,282
CC de la Vallée d'Ossau,24,110,64,198,25,120,61,206,s.s,55,81,182,15,16,s.s,404
CC de la Vallée de Chamonix-Mont-Blanc,28,203,40,271,20,172,59,251,s.s,74,123,148,26,40,s.s,522
CC de la Vallée de Kaysersberg,44,157,80,281,32,148,82,262,s.s,68,109,262,32,19,s.s,543
CC de la Vallée de Munster,38,141,100,279,49,153,114,316,s.s,53,117,259,48,61,s.s,595
CC de la Vallée de Saint-Amarin,45,134,102,281,37,109,89,235,s.s,42,95,263,31,50,s.s,516
CC de la Vallée de Villé,26,91,50,167,25,95,61,181,36,42,55,155,32,28,",",348
CC de la Vallée de l'Oise et des Trois Forêts,103,399,213,715,78,452,180,710,s.s,206,331,450,87,99,s.s,1425
CC de la Vallée de l'homme,51,250,137,438,42,287,161,490,s.s,121,216,360,57,70,s.s,928
CC de la Vallée de la Bruche,72,232,141,445,57,208,126,391,s.s,71,163,408,50,88,s.s,836
CC de la Vallée de la Doller et du Soultzbach,51,157,99,307,57,150,106,313,s.s,58,135,311,29,37,s.s,620
CC de la Vallée de la Haute Sarthe,21,69,51,141,22,73,45,140,10,28,51,146,19,27,",",281
CC de la Vallée du Gapeau,135,380,197,712,88,414,215,717,s.s,165,327,564,96,116,s.s,1429
CC de la Vallée du Garon (Ccvg),75,290,160,525,59,335,138,532,s.s,157,209,319,51,74,s.s,1057
CC de la Vallée du Lot et du Vignoble,53,199,128,380,45,181,140,366,64,75,146,326,55,80,",",746
CC de la Vanne et du Pays d'Othe,30,104,70,204,31,131,64,226,s.s,35,83,199,29,55,s.s,430
CC de la Veyle,67,188,116,371,54,201,101,356,s.s,74,167,325,42,63,s.s,727
CC des 2 Vallées,46,162,95,303,34,145,95,274,s.s,77,131,214,37,39,s.s,577
CC des 4 Rivières,125,378,209,712,111,358,194,663,s.s,93,249,668,123,172,s.s,1375
CC des 4b Sud Charente,64,231,129,424,59,220,143,422,s.s,86,174,391,45,88,s.s,846
CC des 7 Vallées,125,430,211,766,136,437,179,752,s.s,126,353,683,115,164,s.s,1518
CC des Albères et de la Côte Vermeille,412,1492,723,2627,309,1407,755,2471,388,491,1201,2136,393,459,30,5098
CC des Aspres,116,497,203,816,107,441,238,786,s.s,142,350,657,148,176,s.s,1602
CC des Ballons des Hautes-Vosges,67,199,158,424,53,175,131,359,s.s,59,142,342,91,115,s.s,783
CC des Baronnies en Drôme Provençale,85,410,222,717,88,405,253,746,s.s,157,332,597,82,121,s.s,1463
CC des Bastides Dordogne-Périgord,63,233,111,407,68,267,156,491,s.s,87,191,404,60,78,s.s,898
CC des Bastides en Haut Agenais Périgord,46,188,99,333,49,207,139,395,s.s,75,159,318,50,78,s.s,728
CC des Campagnes de l'Artois,101,309,191,601,108,375,158,641,s.s,132,268,564,69,95,s.s,1242
CC des Causses À l'Aubrac,36,129,68,233,30,123,77,230,37,38,106,204,33,45,",",463
CC des Collines du Nord Dauphiné,50,183,105,338,59,215,132,406,s.s,102,184,289,34,43,s.s,744
CC des Collines du Perche,18,55,35,108,18,68,41,127,16,25,35,109,15,35,",",235
CC des Collines du Perche Normand,42,116,63,221,33,119,55,207,s.s,27,73,207,35,51,s.s,428
CC des Combes,19,83,29,131,12,69,35,116,13,16,45,131,19,23,",",247
CC des Coteaux Arrats Gimone,11,85,49,145,20,107,59,186,47,43,74,131,17,19,",",331
CC des Coteaux Bellevue,53,157,90,300,35,208,92,335,s.s,125,132,211,22,27,s.s,635
CC des Coteaux Bordelais,63,207,92,362,39,253,108,400,s.s,132,182,246,37,34,s.s,762
CC des Coteaux de Pouyastruc et du Canton de Tournay,31,112,69,212,27,109,69,205,25,60,87,206,16,23,",",417
CC des Coteaux du Girou,59,173,104,336,46,192,115,353,140,101,176,216,28,28,",",689
CC des Coteaux et Landes de Gascogne,44,165,98,307,39,172,111,322,s.s,54,121,306,32,71,s.s,629
CC des Coëvrons,74,268,126,468,60,249,116,425,s.s,54,172,422,77,111,s.s,893
CC des Crêtes Préardennaises,71,260,149,480,54,275,140,469,s.s,89,177,440,79,102,s.s,949
CC des Cévennes Au Mont Lozère,16,78,38,132,s.s,83,s.s,132,43,41,65,85,16,14,s.s,264
CC des Cévennes Gangeoises et Suménoises,73,303,156,532,61,295,138,494,s.s,120,241,409,73,74,s.s,1026
CC des Deux Morin,128,358,159,645,104,414,170,688,s.s,129,291,579,113,138,s.s,1333
CC des Deux Rives,96,311,120,527,89,325,139,553,s.s,73,197,454,100,197,s.s,1080
CC des Deux Vallées,114,319,150,583,73,332,118,523,s.s,100,242,480,89,117,s.s,1106
CC des Deux Vallées Vertes,39,152,117,308,36,141,104,281,s.s,67,96,277,60,57,s.s,589
CC des Forêts du Perche,26,113,52,191,25,90,62,177,15,27,69,165,50,42,",",368
CC des Gorges de l'Ardèche,123,443,220,786,82,435,274,791,s.s,218,342,710,98,87,s.s,1577
CC des Grands Lacs,138,492,238,868,122,674,350,1146,s.s,246,499,847,99,156,s.s,2014
CC des Hautes Terres de l'Aubrac,11,39,15,65,13,35,18,66,s.s,15,37,60,s.s,s.s,s.s,131
CC des Hautes Vosges,132,412,286,830,83,328,264,675,s.s,137,304,693,137,141,s.s,1505
CC des Hauts de Flandre,183,552,258,993,178,641,305,1124,167,204,501,897,122,216,10,2117
CC des Hauts du Perche,40,96,71,207,20,90,53,163,s.s,32,62,187,28,38,s.s,370
CC des Hauts du Val de Saône,23,108,49,180,29,82,63,174,23,23,52,171,32,53,",",354
CC des Lacs de Champagne,47,141,62,250,31,149,55,235,s.s,37,68,216,65,71,s.s,485
CC des Lacs et Montagnes du Haut-Doubs,30,216,99,345,19,204,66,289,s.s,75,133,259,33,30,s.s,634
CC des Landes d'Armagnac,36,132,74,242,23,136,103,262,s.s,53,109,235,23,43,s.s,504
CC des Lisières de l'Oise,59,190,113,362,46,190,117,353,s.s,70,139,310,53,75,s.s,715
CC des Loges,123,401,180,704,95,449,194,738,s.s,200,272,569,95,172,s.s,1442
CC des Luys en Béarn,86,243,157,486,53,325,137,515,s.s,117,269,424,29,35,s.s,1001
"CC des Marchés du Périg Or Limousin, Thiviers-Jumilhac",37,181,103,321,37,156,96,289,s.s,49,128,271,46,62,s.s,610
CC des Montagnes du Giffre,17,109,65,191,20,97,67,184,s.s,50,80,155,24,17,s.s,375
CC des Monts d'Alban et du Villefranchois,14,67,40,121,18,79,40,137,s.s,27,52,120,12,10,s.s,258
CC des Monts de Gy,18,54,26,98,15,61,29,105,s.s,22,38,88,11,27,s.s,203
CC des Monts de Lacaune et de la Montagne du Haut Languedoc,27,82,71,180,20,82,74,176,30,44,76,135,32,39,",",356
CC des Monts du Lyonnais,66,253,134,453,51,266,126,443,s.s,111,205,345,52,79,s.s,896
CC des Monts du Pilat,42,126,66,234,24,127,59,210,s.s,56,96,175,20,22,s.s,444
CC des Pays d'Oise et d'halatte,154,505,258,917,118,485,234,837,s.s,203,355,684,134,201,s.s,1754
"CC des Pays de Briey, du Jarnisy et de L?orne",242,813,413,1468,177,776,467,1420,s.s,227,565,1473,161,293,s.s,2888
"CC des Pays de Caldaguès-Aubrac, Pierrefort-Neuvéglise, Planèze, Saint-Flour Margeride",58,209,119,386,46,196,114,356,s.s,80,160,368,42,41,s.s,742
CC des Pays de Cayres et de Pradelles,11,44,42,97,16,49,29,94,12,23,37,94,16,s.s,s.s,191
CC des Pays de Rhône et Ouvèze,251,1002,443,1696,261,1060,435,1756,s.s,311,714,1393,258,510,s.s,3452
CC des Pays de l'Aigle,107,373,188,668,87,391,168,646,s.s,85,220,675,96,173,s.s,1314
CC des Pays du Sel et du Vermois,107,429,172,708,109,328,170,607,s.s,117,270,629,83,122,s.s,1315
CC des Paysages de la Champagne,92,211,107,410,55,190,101,346,s.s,61,138,359,65,89,s.s,756
CC des Portes Euréliennes D Ile de France,179,668,309,1156,135,665,297,1097,253,279,467,896,158,187,13,2253
CC des Portes d'Ariège Pyrénées,223,677,319,1219,161,765,328,1254,197,208,524,1050,220,264,10,2473
CC des Portes de Romilly Sur Seine,111,455,256,822,121,533,211,865,s.s,75,284,764,168,299,s.s,1687
CC des Portes de Rosheim,43,143,84,270,26,136,80,242,s.s,71,90,205,21,28,s.s,512
CC des Portes de Sologne,44,123,72,239,31,153,71,255,s.s,64,111,191,24,38,s.s,494
CC des Portes de Vassivière,16,72,52,140,19,59,34,112,s.s,25,51,105,17,26,s.s,252
CC des Portes de l'Entre Deux Mers,49,264,119,432,52,279,111,442,s.s,150,200,277,34,41,s.s,874
CC des Portes de la Thiérache,52,123,86,261,36,118,78,232,s.s,24,61,215,84,101,s.s,493
CC des Portes du Luxembourg,81,273,159,513,81,284,134,499,s.s,71,179,519,63,127,s.s,1012
CC des Quatre Rivières,81,296,169,546,79,335,158,572,s.s,115,232,485,61,97,s.s,1118
CC des Quatre Territoires,26,85,59,170,20,76,55,151,s.s,36,75,116,35,31,s.s,321
CC des Quatre Vallées,62,201,127,390,48,234,109,391,s.s,65,156,381,67,66,s.s,781
CC des Rives du Haut Allier,47,206,146,399,36,172,128,336,s.s,67,167,318,44,59,s.s,735
CC des Sablons,165,532,252,949,163,604,272,1039,155,186,459,765,152,259,12,1988
CC des Savanes,227,692,403,1322,268,1394,451,2113,105,116,429,958,266,1551,10,3435
CC des Sorgues du Comtat,291,935,435,1661,226,1019,452,1697,261,314,677,1442,207,445,12,3358
CC des Sources de l'Orne,44,139,73,256,36,114,63,213,s.s,36,90,228,31,59,s.s,469
CC des Sources du Lac d'Annecy,41,172,69,282,36,181,91,308,s.s,67,115,252,20,42,s.s,590
CC des Sucs,53,174,116,343,44,185,116,345,s.s,67,125,310,45,68,s.s,688
CC des Terres d'Apcher-Margeride-Aubrac,21,91,42,154,20,75,51,146,s.s,39,68,110,22,22,s.s,300
CC des Terres d'Auxois,40,182,118,340,45,148,83,276,s.s,53,113,298,28,65,s.s,616
CC des Terres du Lauragais,106,411,187,704,76,474,198,748,s.s,232,321,489,57,62,s.s,1452
CC des Terres du Val de Loire,145,450,243,838,101,494,232,827,s.s,212,355,715,87,137,s.s,1665
CC des Trois Forêts,26,64,36,126,22,69,33,124,s.s,29,60,107,14,26,s.s,250
CC des Vallons du Lyonnais (Ccvl),61,253,103,417,54,270,126,450,s.s,146,178,285,28,37,s.s,867
CC des Vallées d'Aigueblanche,17,63,36,116,15,88,62,165,s.s,25,62,115,19,30,s.s,281
CC des Vallées d'Auge et du Merlerault,55,213,122,390,45,180,96,321,s.s,51,109,375,61,86,s.s,711
CC des Vallées de Thônes,47,155,58,260,22,148,69,239,s.s,80,98,178,17,21,s.s,499
CC des Vallées de la Braye et de l'Anille,50,147,99,296,46,145,84,275,s.s,45,90,276,46,83,s.s,571
CC des Vallées de la Tille et de l'Ignon,43,146,52,241,34,114,72,220,s.s,49,87,206,31,45,s.s,461
CC des Vallées du Clain,88,208,90,386,46,164,94,304,s.s,84,157,298,38,37,s.s,690
CC des Vallées du Haut-Anjou,119,318,126,563,94,396,146,636,s.s,143,276,478,75,109,s.s,1199
CC des Vals d'Aix et Isable,16,63,42,121,15,53,29,97,s.s,17,43,105,13,21,s.s,218
CC des Villes Soeurs,213,569,314,1096,183,588,353,1124,s.s,145,412,1098,205,267,s.s,2220
CC des Vosges Côté Sud Ouest,34,135,92,261,33,124,87,244,s.s,37,89,238,50,62,s.s,505
CC des Vosges du Sud,42,149,96,287,22,159,96,277,s.s,59,102,249,52,45,s.s,564
CC du Barséquanais en Champagne,70,263,137,470,64,226,112,402,s.s,47,113,416,106,148,s.s,872
CC du Bas Armagnac,19,71,58,148,34,85,60,179,19,30,76,152,26,24,",",327
CC du Bassin d'Arcachon Nord Atlantique (Coban Atlantique),257,879,463,1599,217,1041,585,1843,415,554,852,1288,141,181,11,3442
CC du Bassin d'Aubenas,212,824,418,1454,193,785,404,1382,289,286,635,1192,190,233,11,2836
CC du Bassin de Joinville en Champagne,67,215,110,392,37,178,104,319,s.s,42,124,354,59,103,s.s,711
CC du Bassin de Marennes,64,236,127,427,46,195,141,382,s.s,85,160,404,42,86,s.s,809
CC du Bassin de Mortagne Au Perche,45,171,77,293,54,138,81,273,s.s,50,98,270,52,55,s.s,566
CC du Bassin de Pompey,167,680,275,1122,122,525,228,875,s.s,173,417,891,138,215,s.s,1997
CC du Bassin de Pont-À-Mousson,162,670,261,1093,151,518,233,902,s.s,181,416,897,146,200,s.s,1995
CC du Bazadais,60,224,120,404,56,247,137,440,65,79,196,381,56,67,",",844
CC du Bocage Bourbonnais,49,186,125,360,31,163,106,300,s.s,61,135,304,43,69,s.s,660
CC du Bocage Mayennais,48,122,91,261,38,124,85,247,s.s,43,96,230,47,59,s.s,508
CC du Bonnevalais,52,116,62,230,45,137,66,248,s.s,43,105,221,30,46,s.s,478
CC du Briançonnais,57,291,82,430,48,262,94,404,s.s,105,217,290,38,53,s.s,834
CC du Brivadois,65,207,118,390,40,213,112,365,s.s,62,141,356,47,79,s.s,755
CC du Béarn des Gaves,44,158,99,301,42,182,124,348,s.s,61,139,313,42,35,s.s,649
CC du Canton d'Erstein,136,472,289,897,149,465,284,898,147,204,314,830,120,168,12,1795
CC du Canton d'Oulchy le Château,25,83,55,163,17,84,40,141,17,32,53,148,20,34,",",304
CC du Canton de Charly Sur Marne,67,236,91,394,55,234,99,388,s.s,68,161,363,67,82,s.s,782
CC du Canton de Criquetot-l'esneval,53,111,84,248,59,163,100,322,s.s,57,146,228,30,52,s.s,570
CC du Canton de Marcigny,12,54,42,108,12,60,40,112,11,25,37,98,15,34,",",220
CC du Canton de Pierre de Bresse,13,58,45,116,15,68,36,119,17,11,41,126,17,23,",",235
CC du Canton de Rumilly,92,342,111,545,81,307,120,508,s.s,129,217,387,79,113,s.s,1053
CC du Canton de Semur en Brionnais,s.s,27,s.s,69,s.s,48,s.s,98,s.s,17,31,70,s.s,16,s.s,167
CC du Canton de Vatan et de Champagne Berrichonne,36,108,62,206,23,88,50,161,24,30,79,190,21,23,",",367
CC du Canton de la Chambre,22,68,25,115,14,69,45,128,29,28,49,111,s.s,18,s.s,243
CC du Cap Corse,27,107,75,209,27,147,61,235,s.s,47,117,159,27,35,s.s,444
CC du Castelrenaudais,68,210,120,398,66,209,121,396,s.s,74,149,360,56,97,s.s,794
CC du Caudrésis et du Catésis,427,1683,713,2823,424,1480,586,2490,158,284,990,2573,448,845,15,5313
CC du Causse de Labastide Murat,15,40,23,78,s.s,41,s.s,86,20,20,43,62,s.s,10,s.s,164
"CC du Cellois, Coeur du Poitou, Mellois et du Val de Boutonne",154,524,234,912,98,413,246,757,s.s,167,337,804,87,136,s.s,1669
CC du Centre Corse,39,110,61,210,40,128,65,233,s.s,27,97,109,55,46,s.s,443
CC du Centre du Haut-Rhin,54,158,95,307,42,142,73,257,s.s,51,109,263,45,47,s.s,564
CC du Chaourçois et du Val d'Armance,29,139,73,241,31,131,88,250,s.s,35,78,244,40,67,s.s,491
CC du Chemin des Dames,20,88,49,157,23,74,40,137,19,20,49,145,34,27,",",294
CC du Châtillonnais en Berry,37,70,37,144,19,57,48,124,12,22,48,141,24,21,",",268
CC du Civraisien en Poitou,116,275,144,535,79,229,135,443,s.s,90,167,494,69,76,s.s,978
CC du Clermontais,172,602,307,1081,128,601,282,1011,s.s,221,479,922,140,164,s.s,2092
CC du Clermontois,167,537,181,885,140,445,165,750,111,150,366,677,151,167,13,1635
CC du Clunisois,34,132,61,227,33,115,74,222,s.s,60,90,176,16,42,s.s,449
CC du Confluent et des Coteaux de Prayssas,73,302,191,566,66,357,186,609,s.s,83,184,398,89,352,s.s,1175
CC du Cordais et du Causse (4 C),15,66,56,137,s.s,68,s.s,114,45,29,62,91,s.s,14,s.s,251
CC du Crestois et de Pays de Saillans Coeur de Drôme,88,364,159,611,57,318,163,538,s.s,132,223,411,72,118,s.s,1149
CC du Créonnais,66,220,99,385,55,246,110,411,s.s,106,179,328,41,50,s.s,796
CC du Cubzaguais,123,513,186,822,126,677,250,1053,s.s,170,412,869,99,165,s.s,1875
CC du Diois,43,281,151,475,32,268,124,424,s.s,128,256,260,28,49,s.s,899
CC du District Urbain de Faulquemont (Duf),98,320,136,554,83,287,168,538,s.s,103,244,502,72,88,s.s,1092
CC du Doubs Baumois,52,173,98,323,29,162,88,279,s.s,47,108,286,38,72,s.s,602
CC du Fronsadais,62,210,86,358,49,268,120,437,s.s,85,164,345,46,80,s.s,795
CC du Frontonnais,74,236,132,442,78,312,142,532,s.s,130,220,367,59,66,s.s,974
CC du Genevois,104,708,288,1100,85,740,240,1065,438,281,450,736,94,149,17,2165
CC du Golfe de Saint-Tropez,477,1876,794,3147,373,1985,884,3242,568,764,1668,2319,519,526,25,6389
CC du Grand Armagnac,33,134,105,272,28,161,144,333,s.s,52,116,243,60,83,s.s,605
CC du Grand Autunois Morvan,151,494,271,916,98,404,274,776,s.s,159,294,776,141,211,s.s,1692
CC du Grand Chambord,56,189,96,341,51,181,123,355,s.s,77,143,323,35,57,s.s,696
CC du Grand Châteaudun,157,520,245,922,125,510,255,890,s.s,142,297,778,197,281,s.s,1812
CC du Grand Langres,81,316,95,492,67,230,137,434,s.s,83,184,424,74,110,s.s,926
CC du Grand Pic Saint-Loup,164,626,296,1086,104,594,276,974,550,348,453,562,81,55,11,2060
CC du Grand Pontarlier,90,455,197,742,66,384,176,626,s.s,144,267,591,80,155,s.s,1368
CC du Grand Roye,146,397,187,730,129,386,209,724,s.s,83,251,695,174,202,s.s,1454
CC du Grand Saint Emilonnais,60,226,92,378,51,237,129,417,64,83,154,321,54,119,",",795
CC du Grand Villefranchois,96,351,184,631,78,330,192,600,s.s,140,284,546,66,77,s.s,1231
CC du Guillestrois et du Queyras,22,102,41,165,21,93,44,158,s.s,47,91,119,13,10,s.s,323
CC du Gâtinais en Bourgogne,55,205,122,382,47,207,134,388,s.s,91,147,357,59,78,s.s,770
CC du Gévaudan,31,104,56,191,17,81,33,131,35,38,66,134,13,36,",",322
CC du Haut Allier,14,57,27,98,s.s,43,s.s,78,23,13,32,76,s.s,18,s.s,176
CC du Haut Lignon,14,73,54,141,18,73,73,164,s.s,30,66,117,28,27,s.s,305
CC du Haut Pays Bigouden,67,245,120,432,46,179,105,330,s.s,119,180,297,33,26,s.s,762
CC du Haut Pays du Montreuillois,56,159,96,311,55,219,81,355,s.s,81,149,286,43,70,s.s,666
CC du Haut Val d'Oise,162,627,272,1061,149,674,183,1006,s.s,208,482,712,177,278,s.s,2067
CC du Haut Vallespir,58,212,149,419,37,192,144,373,s.s,66,170,371,57,68,s.s,792
CC du Haut-Chablais,11,100,43,154,14,83,40,137,s.s,52,68,87,14,21,s.s,291
CC du Haut-Jura (Arcade),38,161,99,298,21,108,70,199,s.s,46,90,199,35,87,s.s,497
CC du Haut-Poitou,117,377,178,672,84,415,196,695,s.s,163,295,617,70,83,s.s,1367
CC du Jovinien,104,340,150,594,86,297,135,518,s.s,87,197,512,71,161,s.s,1112
CC du Kochersberg,31,159,89,279,52,193,92,337,s.s,100,122,202,27,26,s.s,616
CC du Kreiz-Breizh (Cckb),51,262,138,451,47,216,131,394,s.s,84,219,345,50,53,s.s,845
CC du Lac d'Aiguebelette (Ccla),11,61,32,104,15,55,32,102,s.s,32,38,80,s.s,s.s,s.s,206
CC du Lautrécois et du Pays d'Agout,38,181,92,311,47,170,84,301,s.s,81,144,244,26,39,s.s,612
CC du Liancourtois,117,326,119,562,86,329,124,539,s.s,134,237,441,86,129,s.s,1101
CC du Limouxin,126,456,277,859,111,460,292,863,s.s,171,393,728,110,177,s.s,1722
CC du Massif du Sancy,31,93,64,188,30,118,100,248,s.s,39,104,176,32,42,s.s,436
CC du Massif du Vercors,23,117,76,216,15,113,83,211,s.s,64,104,140,11,11,s.s,427
CC du Mont des Avaloirs,39,202,91,332,53,137,75,265,s.s,42,99,290,67,70,s.s,597
CC du Montbardois,42,154,91,287,45,118,86,249,s.s,36,86,277,34,70,s.s,536
CC du Nivernais Bourbonnais,16,56,28,100,16,44,31,91,s.s,17,34,96,13,24,s.s,191
CC du Nogentais,72,254,122,448,65,297,138,500,s.s,73,151,439,91,125,s.s,948
CC du Nord Est Béarn,89,283,172,544,45,346,191,582,s.s,156,239,464,46,63,s.s,1126
CC du Pays Arnay Liernais,20,62,39,121,25,59,53,137,s.s,18,55,122,s.s,30,s.s,258
CC du Pays Beaume-Drobie,46,221,117,384,43,189,120,352,s.s,75,188,317,36,39,s.s,736
CC du Pays Bellegardien (Ccpb),69,383,145,597,70,351,124,545,s.s,111,238,484,66,135,s.s,1142
CC du Pays Bigouden Sud,142,465,247,854,98,436,303,837,s.s,225,408,649,79,67,s.s,1691
CC du Pays Châtillonnais,74,261,165,500,59,237,157,453,s.s,67,149,452,72,165,s.s,953
CC du Pays Entre Loire et Rhône,36,129,92,257,27,129,73,229,s.s,49,100,218,36,52,s.s,486
CC du Pays Fertois,120,432,179,731,109,468,172,749,s.s,131,340,585,140,148,s.s,1480
CC du Pays Fertois et du Bocage Carrougien,15,47,31,93,15,35,30,80,s.s,16,39,87,s.s,14,s.s,173
CC du Pays Fléchois,113,288,131,532,88,294,163,545,s.s,72,169,519,91,155,s.s,1077
CC du Pays Fouesnantais,85,336,166,587,73,326,211,610,s.s,183,313,384,49,45,s.s,1197
CC du Pays Foyen,82,277,175,534,75,293,146,514,s.s,59,202,430,91,203,s.s,1048
CC du Pays Gentiane,10,40,26,76,s.s,42,s.s,77,s.s,11,35,74,13,s.s,s.s,153
CC du Pays Grenadois,28,67,42,137,19,106,41,166,30,36,62,143,11,21,",",303
CC du Pays Haut Val d'Alzette,68,460,183,711,68,420,175,663,s.s,106,298,571,97,192,s.s,1374
"CC du Pays Houdanais (C,C,P,H,)",77,237,130,444,67,283,151,501,s.s,169,220,287,30,52,s.s,945
CC du Pays Loudunais,92,317,160,569,85,345,169,599,s.s,72,219,584,74,154,s.s,1168
CC du Pays Morcenais,31,125,77,233,35,148,77,260,s.s,40,107,213,36,64,s.s,493
CC du Pays Mornantais (Copamo),55,224,132,411,68,252,115,435,167,151,189,272,28,39,",",846
CC du Pays Noyonnais,215,670,307,1192,181,713,265,1159,s.s,165,433,1051,207,395,s.s,2351
CC du Pays Orne Moselle,214,880,424,1518,178,876,487,1541,200,250,584,1494,175,345,11,3059
CC du Pays Rhénan,95,270,233,598,74,346,238,658,s.s,114,199,601,79,126,s.s,1256
CC du Pays Ribéracois,66,234,134,434,53,230,141,424,s.s,88,179,363,66,90,s.s,858
CC du Pays Rignacois,13,41,29,83,10,50,26,86,s.s,24,28,84,s.s,s.s,s.s,169
CC du Pays Riolais,31,110,50,191,29,123,68,220,42,61,91,172,24,21,",",411
CC du Pays Rochois,41,326,147,514,53,327,139,519,s.s,155,215,365,42,94,s.s,1033
CC du Pays Roussillonnais,237,692,297,1226,198,898,372,1468,176,263,532,1032,206,470,15,2694
CC du Pays Réthelois,95,370,196,661,92,368,158,618,s.s,112,230,623,84,166,s.s,1279
CC du Pays Solesmois,68,285,127,480,72,275,132,479,s.s,70,205,449,49,128,s.s,959
CC du Pays Tarusate,74,214,117,405,37,237,125,399,s.s,83,162,391,47,78,s.s,804
CC du Pays Viganais,55,275,169,499,35,194,108,337,s.s,84,200,300,76,77,s.s,836
CC du Pays d'Alésia et de la Seine,27,85,48,160,34,72,49,155,s.s,21,55,158,16,40,s.s,315
CC du Pays d'Ancenis,174,634,283,1091,150,746,279,1175,s.s,278,493,954,105,190,s.s,2266
CC du Pays d'Etain,28,95,53,176,30,93,48,171,s.s,30,59,187,33,24,s.s,347
CC du Pays d'Iroise,141,409,227,777,87,448,310,845,290,224,377,587,47,79,18,1622
CC du Pays d'Issoudun,129,345,156,630,89,229,147,465,s.s,82,217,541,90,107,s.s,1095
CC du Pays d'Olmes,79,304,207,590,53,268,210,531,s.s,82,224,521,103,134,s.s,1121
CC du Pays d'Oloron et des Vallées du Haut Béarn,112,403,226,741,93,366,265,724,s.s,148,312,684,77,98,s.s,1465
CC du Pays d'Othe Aixois,37,125,69,231,23,119,76,218,34,25,74,210,44,62,",",449
CC du Pays d'Urfé,s.s,42,s.s,85,12,30,31,73,s.s,21,26,75,s.s,19,s.s,158
CC du Pays d'Uzerche,24,74,61,159,19,78,42,139,s.s,28,58,143,s.s,31,s.s,298
CC du Pays d'huriel,29,83,61,173,12,86,54,152,s.s,34,55,175,18,18,s.s,325
CC du Pays d'héricourt,83,272,155,510,72,298,157,527,s.s,91,207,483,78,113,s.s,1037
CC du Pays de Barr,83,253,136,472,46,274,127,447,s.s,104,171,403,52,81,s.s,919
CC du Pays de Bitche,107,336,356,799,93,330,278,701,s.s,128,275,681,98,221,s.s,1500
CC du Pays de Bray,93,246,136,475,69,286,149,504,s.s,88,208,454,92,88,s.s,979
CC du Pays de Bâgé et de Pont-De-Vaux,59,197,89,345,55,234,113,402,s.s,82,158,332,43,63,s.s,747
"CC du Pays de Chalindrey, de Vannier Amance et de la Région de Bourbonne-Les-Bains",62,149,98,309,40,156,117,313,s.s,43,110,308,63,69,s.s,622
CC du Pays de Château-Gontier,106,256,128,490,76,282,139,497,s.s,84,172,440,89,115,s.s,987
CC du Pays de Châteaugiron,59,215,79,353,51,208,84,343,s.s,108,173,201,21,42,s.s,696
CC du Pays de Colombey et du Sud Toulois,45,102,62,209,30,134,60,224,s.s,48,92,192,31,38,s.s,433
CC du Pays de Conches,97,284,131,512,60,238,118,416,s.s,87,163,459,80,76,s.s,928
CC du Pays de Craon,74,217,124,415,50,235,100,385,s.s,60,179,355,72,79,s.s,800
CC du Pays de Cruseilles,28,177,84,289,30,188,64,282,s.s,92,112,191,11,28,s.s,571
CC du Pays de Dol et de la Baie du Mont Saint-Michel,63,248,156,467,68,282,144,494,s.s,100,191,404,77,104,s.s,961
CC du Pays de Duras,12,63,36,111,18,64,47,129,s.s,27,52,85,17,36,s.s,240
CC du Pays de Falaise,131,362,185,678,107,344,150,601,s.s,84,251,572,99,196,s.s,1279
CC du Pays de Fayence,146,407,247,800,107,402,255,764,s.s,195,378,594,99,126,s.s,1564
CC du Pays de Fénelon,31,127,91,249,46,133,90,269,s.s,63,107,231,35,38,s.s,518
CC du Pays de Gex,180,1376,568,2124,134,1443,400,1977,1084,548,781,1204,186,270,28,4101
CC du Pays de Honfleur-Beuzeville,153,450,199,802,132,474,214,820,s.s,144,303,704,152,187,s.s,1622
CC du Pays de Lalbenque-Limogne,23,122,83,228,15,113,93,221,s.s,64,110,157,28,20,s.s,449
CC du Pays de Lamastre,21,79,60,160,10,96,57,163,s.s,35,71,135,15,28,s.s,323
CC du Pays de Landerneau-Daoulas,159,477,247,883,119,546,234,899,s.s,263,417,700,56,79,s.s,1782
CC du Pays de Landivisiau,97,371,160,628,118,435,171,724,s.s,152,342,611,81,64,s.s,1352
CC du Pays de Lanouaille,33,145,75,253,21,127,105,253,s.s,44,110,208,41,45,s.s,506
CC du Pays de Lapalisse,27,106,78,211,26,97,66,189,s.s,28,74,204,35,38,s.s,400
CC du Pays de Lauzun,28,123,67,218,23,112,87,222,29,39,77,216,28,51,",",440
CC du Pays de Limours (Ccpl),50,189,113,352,33,176,90,299,s.s,107,149,171,20,29,s.s,651
CC du Pays de Loiron,41,109,52,202,34,129,46,209,44,56,93,161,22,35,",",411
CC du Pays de Lubersac-Pompadour,17,61,44,122,23,67,42,132,s.s,23,52,102,20,34,s.s,254
CC du Pays de Lumbres,91,270,125,486,98,317,111,526,s.s,95,254,451,51,95,s.s,1012
CC du Pays de Lunel,325,1345,636,2306,250,1191,518,1959,340,389,907,1618,344,632,35,4265
CC du Pays de Lure,99,307,166,572,83,269,163,515,s.s,85,179,487,92,185,s.s,1087
CC du Pays de Luxeuil,48,257,132,437,43,246,113,402,s.s,65,147,400,74,113,s.s,839
CC du Pays de Mauriac,27,68,36,131,11,54,36,101,s.s,14,31,132,25,15,s.s,232
CC du Pays de Maîche,26,233,137,396,37,240,113,390,s.s,52,162,361,75,86,s.s,786
CC du Pays de Meslay-Grez,24,126,52,202,26,131,59,216,s.s,34,85,189,40,36,s.s,418
CC du Pays de Mirepoix,45,171,108,324,38,204,109,351,s.s,73,147,268,56,47,s.s,675
CC du Pays de Montbozon et du Chanois,15,56,28,99,17,60,33,110,s.s,20,41,100,16,16,s.s,209
CC du Pays de Montfaucon,16,61,56,133,16,71,38,125,s.s,24,52,120,19,28,s.s,258
CC du Pays de Montmédy,17,75,52,144,18,75,43,136,s.s,17,54,136,20,31,s.s,280
CC du Pays de Mormal,215,772,324,1311,212,736,309,1257,s.s,211,541,1128,168,328,s.s,2568
CC du Pays de Mortagne,69,176,82,327,51,206,117,374,s.s,85,174,275,39,61,s.s,701
CC du Pays de Niederbronn-Les-Bains,75,259,156,490,75,231,132,438,s.s,70,138,498,69,107,s.s,928
CC du Pays de Phalsbourg,57,132,84,273,41,168,107,316,s.s,48,120,275,47,57,s.s,589
CC du Pays de Pierrefontaine - Vercel,60,201,97,358,51,255,103,409,s.s,89,151,341,45,74,s.s,767
CC du Pays de Pontchâteau St Gildas des Bois,96,320,130,546,122,384,156,662,88,125,289,581,62,47,16,1208
CC du Pays de Pouzauges,55,155,90,300,72,219,84,375,s.s,69,120,320,45,54,s.s,675
CC du Pays de Redon,228,825,483,1536,231,809,440,1480,286,315,611,1365,206,211,22,3016
CC du Pays de Revigny Sur Ornain,35,72,54,161,16,84,41,141,s.s,19,65,131,24,49,s.s,302
CC du Pays de Ribeauvillé,36,156,82,274,42,185,94,321,s.s,85,112,249,33,45,s.s,595
"CC du Pays de Rouffach, Vignobles et Châteaux",41,99,57,197,28,97,57,182,s.s,48,73,169,17,25,s.s,379
CC du Pays de Saint Aulaye,21,92,53,166,31,108,54,193,19,24,67,177,32,40,",",359
CC du Pays de Saint Yrieix,44,150,73,267,31,130,72,233,43,48,108,214,37,50,",",500
CC du Pays de Saint-Eloy,37,170,125,332,42,155,108,305,s.s,56,113,319,44,60,s.s,637
CC du Pays de Saint-Fulgent - les Essarts,53,202,83,338,53,194,99,346,s.s,92,152,306,37,59,s.s,684
CC du Pays de Sainte-Odile,43,211,89,343,56,239,81,376,s.s,74,143,308,40,69,s.s,719
CC du Pays de Salars,11,60,36,107,18,56,30,104,s.s,35,43,85,12,12,s.s,211
CC du Pays de Salers,13,59,56,128,10,66,57,133,s.s,20,49,132,20,17,s.s,261
CC du Pays de Sancey-Belleherbe,13,38,36,87,11,38,27,76,18,10,35,73,10,17,",",163
CC du Pays de Serres en Quercy,28,144,68,240,31,153,69,253,s.s,42,98,208,43,59,s.s,493
CC du Pays de Sommières,114,393,200,707,73,423,219,715,s.s,185,318,563,84,100,s.s,1422
CC du Pays de St Gilles-Croix-De-Vie,185,637,371,1193,158,675,494,1327,193,285,595,1104,149,182,12,2520
CC du Pays de Stenay et du Val Dunois,47,141,79,267,30,121,72,223,s.s,30,82,257,42,55,s.s,490
CC du Pays de Tarascon,36,133,73,242,29,124,97,250,s.s,45,104,226,34,39,s.s,492
CC du Pays de Thelle et Ruraloise,253,719,351,1323,195,803,320,1318,s.s,305,615,1133,193,180,s.s,2641
CC du Pays de Trie et du Magnoac,22,67,44,133,19,76,29,124,s.s,24,52,115,21,22,s.s,257
CC du Pays de Tronçais,25,104,91,220,14,79,65,158,22,42,63,185,27,39,",",378
CC du Pays de Valois,208,653,320,1181,139,695,322,1156,230,269,512,901,171,239,15,2337
CC du Pays de Villeneuve en Armagnac Landais,26,52,45,123,17,63,52,132,22,27,51,107,16,32,",",255
CC du Pays de Villersexel,23,90,65,178,20,85,50,155,16,28,54,158,25,52,",",333
CC du Pays de Wissembourg,56,177,150,383,50,181,132,363,s.s,64,124,339,52,109,s.s,746
CC du Pays de l'Arbresle (Ccpa),128,343,176,647,84,362,192,638,s.s,222,267,425,62,89,s.s,1285
CC du Pays de l'Ourcq,80,283,138,501,73,247,102,422,s.s,61,199,414,81,112,s.s,923
CC du Pays de l'Ozon,67,237,113,417,47,256,97,400,s.s,125,153,299,32,59,s.s,817
CC du Pays de l'huisne Sarthoise,111,315,144,570,88,353,156,597,s.s,88,223,520,104,143,s.s,1167
CC du Pays de la Châtaigneraie,34,142,95,271,35,163,88,286,s.s,57,104,265,41,50,s.s,557
CC du Pays de la Serre,76,267,144,487,70,254,108,432,s.s,55,166,414,100,148,s.s,919
CC du Pays de la Zorn,45,112,56,213,28,129,74,231,s.s,60,88,209,22,22,s.s,444
CC du Pays des Abers,107,393,183,683,85,490,225,800,s.s,199,357,610,57,64,s.s,1483
CC du Pays des Achards,53,190,96,339,42,203,110,355,s.s,83,159,318,32,57,s.s,694
CC du Pays des Ecrins,16,90,37,143,21,67,24,112,s.s,38,70,64,18,26,s.s,255
CC du Pays des Herbiers,65,246,92,403,77,284,126,487,s.s,103,204,354,66,90,s.s,890
CC du Pays des Lacs,23,80,34,137,12,83,36,131,22,47,66,104,15,14,",",268
CC du Pays des Paillons,100,348,177,625,78,352,177,607,s.s,130,265,524,92,95,s.s,1232
CC du Pays des Sorgues et des Monts de Vaucluse,138,631,297,1066,140,635,307,1082,s.s,250,454,818,144,234,s.s,2148
CC du Pays des Sources,91,253,127,471,59,272,123,454,s.s,113,211,390,76,76,s.s,925
CC du Pays des Trois Rivières,173,576,209,958,164,467,182,813,s.s,99,279,862,192,289,s.s,1771
CC du Pays du Coquelicot,123,394,234,751,116,424,175,715,s.s,125,287,715,116,144,s.s,1466
CC du Pays du Neubourg,70,180,108,358,62,213,105,380,s.s,44,162,347,65,77,s.s,738
CC du Pays du Saintois,32,146,62,240,39,128,72,239,s.s,53,107,225,26,33,s.s,479
CC du Pays du Sanon,23,60,33,116,15,53,25,93,s.s,21,61,92,19,s.s,s.s,209
CC du Pays du Vermandois,195,558,251,1004,135,527,237,899,s.s,125,336,899,200,269,s.s,1903
CC du Perche,81,271,141,493,87,260,127,474,s.s,85,164,432,99,118,s.s,967
CC du Perche et Haut Vendômois,26,78,75,179,21,90,47,158,s.s,29,62,153,26,37,s.s,337
CC du Pilat Rhodanien,46,159,95,300,46,178,109,333,77,74,128,275,36,43,",",633
CC du Pithiverais,117,408,206,731,132,470,206,808,s.s,121,288,631,132,286,s.s,1539
CC du Pithiverais-Gâtinais,114,300,174,588,81,351,179,611,s.s,106,244,506,116,166,s.s,1199
CC du Piémont Cévenol,103,416,208,727,76,389,204,669,s.s,151,315,560,90,118,s.s,1396
CC du Plateau Picard,167,411,183,761,144,407,151,702,68,102,294,688,139,162,10,1463
CC du Plateau d'hauteville,11,66,27,104,12,38,27,77,s.s,15,43,80,11,15,s.s,181
CC du Plateau de Frasne et du Val de Drugeon (Cfd),s.s,63,s.s,103,10,54,29,93,s.s,16,44,94,11,17,s.s,196
CC du Plateau de Lannemezan,59,232,128,419,44,223,148,415,s.s,87,193,378,37,64,s.s,834
CC du Plateau de Montbazens,11,47,20,78,15,61,16,92,22,24,44,60,s.s,11,s.s,170
CC du Plateau de Russey,11,62,55,128,14,71,31,116,s.s,20,34,123,21,24,s.s,244
CC du Pont du Gard,111,427,232,770,95,470,249,814,s.s,178,338,656,98,157,s.s,1584
CC du Provinois,144,500,235,879,137,516,225,878,s.s,169,401,736,122,198,s.s,1757
CC du Périgord Nontronnais,39,153,105,297,35,147,92,274,s.s,53,120,250,40,59,s.s,571
CC du Quercy Blanc,21,99,77,197,12,80,63,155,s.s,40,76,156,23,27,s.s,352
CC du Quercy Caussadais,105,347,155,607,106,385,153,644,s.s,101,244,537,102,184,s.s,1251
CC du Quercy Rouergue et des Gorges de l'Aveyron,30,126,77,233,22,148,57,227,s.s,54,116,175,26,34,s.s,460
CC du Rhône Aux Gorges de l'Ardèche,111,343,192,646,97,389,229,715,s.s,126,278,567,116,171,s.s,1361
CC du Ried de Marckolsheim,66,197,110,373,60,225,138,423,s.s,67,151,400,57,80,s.s,796
CC du Romorantinais et du Monestois,125,496,265,886,118,444,238,800,s.s,125,243,801,157,282,s.s,1686
CC du Rouillacais,32,133,53,218,35,121,69,225,29,47,78,209,39,41,",",443
CC du Royans-Vercors,26,121,57,204,19,121,65,205,s.s,35,86,182,28,29,s.s,409
CC du Réolais en Sud Gironde,103,420,206,729,99,421,199,719,s.s,121,273,654,101,185,s.s,1448
CC du Réquistanais,13,35,14,62,s.s,34,s.s,63,13,16,21,55,12,s.s,s.s,125
CC du Sammiellois,37,144,83,264,37,117,87,241,s.s,23,91,254,51,67,s.s,505
CC du Sartenais Valinco,68,253,134,455,65,320,147,532,s.s,83,201,313,85,227,s.s,987
CC du Saulnois,97,303,190,590,74,279,148,501,s.s,83,242,521,76,98,s.s,1091
CC du Saves,22,62,44,128,24,106,60,190,s.s,43,65,140,16,15,s.s,318
CC du Secteur de Saint Loubes,102,344,151,597,90,394,156,640,s.s,166,296,448,68,100,s.s,1237
CC du Seignanx,96,370,154,620,81,405,171,657,s.s,187,298,496,58,59,s.s,1277
CC du Serein,17,65,56,138,22,66,28,116,22,22,62,120,s.s,19,s.s,254
CC du Sisteronais-Buëch,123,458,216,797,82,427,233,742,s.s,129,352,647,113,163,s.s,1539
CC du Sor et de l'Agout,92,257,145,494,73,273,150,496,s.s,121,223,440,55,55,s.s,990
CC du Sud Avesnois,237,729,323,1289,190,656,254,1100,s.s,110,428,1238,205,349,s.s,2389
CC du Sud Corse,208,778,282,1268,183,949,336,1468,212,271,663,906,247,418,19,2736
CC du Sud Est du Pays Manceau,44,136,58,238,44,144,79,267,s.s,56,124,213,27,33,s.s,505
CC du Sud Estuaire,91,365,157,613,105,358,176,639,s.s,152,301,542,64,58,s.s,1252
CC du Sud Gironde,162,732,299,1193,155,774,353,1282,s.s,255,450,1039,182,350,s.s,2475
CC du Sud Grésivaudan,176,486,303,965,132,566,253,951,202,208,408,770,139,178,11,1916
CC du Sud Marnais,23,91,37,151,23,102,45,170,s.s,24,41,175,19,45,s.s,321
CC du Sud Messin,50,138,59,247,30,152,69,251,s.s,73,115,224,20,26,s.s,498
CC du Sud Territoire,79,363,179,621,92,334,219,645,s.s,94,232,608,92,145,s.s,1266
CC du Sud-Artois,114,301,169,584,94,348,136,578,s.s,90,255,554,78,120,s.s,1162
CC du Ternois,196,570,256,1022,188,480,204,872,74,139,430,874,136,225,16,1894
CC du Terrassonnais en Périgord Noir Thenon Hautefort,74,297,190,561,73,330,188,591,s.s,96,246,548,73,112,s.s,1152
CC du Territoire Nord Picardie,165,546,286,997,122,510,207,839,107,148,334,856,154,226,11,1836
CC du Territoire de Beaurepaire,55,183,127,365,44,231,124,399,s.s,56,131,326,74,132,s.s,764
CC du Territoire de Fresnes en Woëvre,17,38,29,84,14,52,29,95,12,17,47,80,10,13,",",179
CC du Territoire de Lunéville À Baccarat,194,782,398,1374,197,627,309,1133,s.s,167,491,1199,210,331,s.s,2507
CC du Thouarsais,135,446,235,816,114,427,235,776,s.s,110,277,792,95,236,s.s,1592
CC du Triangle Vert,28,111,75,214,26,113,72,211,s.s,48,82,213,23,39,s.s,425
CC du Trièves,23,135,57,215,13,122,56,191,s.s,56,112,128,14,11,s.s,406
CC du Val D Amboise,106,416,204,726,113,445,238,796,s.s,159,302,676,74,159,s.s,1522
CC du Val Marnaysien,43,127,68,238,19,126,61,206,s.s,51,88,211,25,40,s.s,444
CC du Val d'Amour,21,69,41,131,18,77,39,134,s.s,26,53,115,21,23,s.s,265
CC du Val d'Argent,46,165,82,293,41,117,66,224,s.s,36,104,221,43,81,s.s,517
CC du Val d'Ay,11,60,35,106,15,67,25,107,19,25,48,91,17,13,",",213
CC du Val d'Essonne (Ccve),164,523,255,942,124,579,227,930,288,275,458,626,91,118,16,1872
CC du Val d'Ille-Aubigné,94,345,138,577,87,377,115,579,194,172,270,395,58,55,12,1156
CC du Val d'Orne,12,61,43,116,s.s,63,s.s,112,17,15,37,112,s.s,34,s.s,228
CC du Val de Bouzanne,21,65,45,131,16,53,39,108,s.s,27,44,119,19,17,s.s,239
CC du Val de Cher,21,68,54,143,15,54,31,100,17,21,51,123,11,20,",",243
CC du Val de Drôme,137,472,251,860,93,502,244,839,s.s,229,333,635,92,216,s.s,1699
CC du Val de Morteau,33,273,190,496,36,283,152,471,s.s,113,166,376,69,138,s.s,967
CC du Val de Sarthe,81,218,120,419,83,232,127,442,s.s,94,194,398,59,66,s.s,861
CC du Val de Somme,115,292,167,574,70,272,131,473,s.s,88,220,452,101,117,s.s,1047
CC du Val de Sully,97,294,133,524,90,314,155,559,s.s,95,182,495,85,161,s.s,1083
CC du Val de Vienne,37,138,64,239,26,114,57,197,s.s,52,103,171,29,34,s.s,436
CC du Val de l'Aisne,93,291,191,575,69,305,160,534,s.s,84,226,507,106,126,s.s,1109
CC du Val de l'Eyre,61,279,118,458,61,321,128,510,102,133,232,392,53,56,",",968
CC du Val de l'Oise,82,254,146,482,66,249,102,417,s.s,54,156,443,74,139,s.s,899
CC du Vallespir,99,453,231,783,91,422,257,770,s.s,125,364,720,107,116,s.s,1553
CC du Vexin Normand,184,471,221,876,142,530,235,907,s.s,150,379,762,148,222,s.s,1783
CC du Vexin-Thelle,93,235,102,430,61,244,118,423,s.s,90,200,355,63,73,s.s,853
CC du Vexin-Val de Seine,66,246,118,430,57,218,118,393,s.s,93,180,340,55,56,s.s,823
CC du Vimeu,114,311,153,578,97,346,130,573,s.s,92,210,560,106,145,s.s,1151
CC du Volvestre,125,363,236,724,91,434,225,750,s.s,170,339,607,97,108,s.s,1474
CC du Warndt,92,362,144,598,72,305,153,530,s.s,69,247,517,84,156,s.s,1128
CC l'Orée de la Brie,60,300,140,500,84,278,118,480,s.s,142,238,303,63,97,s.s,980
CC la Clayette Chauffailles en Brionnais,38,132,99,269,24,127,105,256,s.s,43,104,236,45,64,s.s,525
CC la Domitienne,162,478,251,891,132,563,272,967,s.s,187,410,887,131,119,s.s,1858
CC la Grandvallière,22,69,24,115,12,55,32,99,s.s,24,45,82,15,21,s.s,214
CC la Rochefoucauld - Porte du Périgord,54,247,159,460,59,241,140,440,s.s,76,172,459,55,68,s.s,900
CC la Septaine,37,103,53,193,30,126,54,210,26,43,78,200,23,33,",",403
CC le Dourdannais en Hurepoix (Ccdh),80,262,123,465,60,256,125,441,122,138,187,314,56,79,10,906
CC le Dunois,21,93,60,174,17,88,47,152,s.s,20,59,169,28,35,s.s,326
CC le Gesnois Bilurien,84,281,149,514,85,328,152,565,s.s,92,213,547,73,98,s.s,1079
CC le Grand Charolais,121,423,289,833,110,428,269,807,s.s,116,297,775,115,225,s.s,1640
CC le Grésivaudan,290,931,482,1703,173,987,498,1658,s.s,497,655,1093,136,206,s.s,3361
CC le Tonnerrois en Bourgogne,64,214,143,421,49,203,120,372,s.s,52,107,390,89,115,s.s,793
CC les Avant-Monts,163,442,244,849,112,488,273,873,s.s,156,395,781,119,123,s.s,1722
CC les Balcons du Dauphiné,289,758,363,1410,219,961,452,1632,262,355,678,1296,197,238,16,3042
CC les Portes Briardes Entre Villes et Forêts,147,521,278,946,94,514,227,835,249,236,427,538,99,217,15,1781
CC les Portes de l'Ile de France,93,310,144,547,64,297,149,510,s.s,125,224,418,79,101,s.s,1057
CC les Trois Provinces,17,78,64,159,17,65,44,126,s.s,22,43,148,31,33,s.s,285
CC les Vals du Dauphiné,221,732,334,1287,192,822,337,1351,s.s,260,559,1119,195,269,s.s,2638
CC les Versants d'Aime,22,96,38,156,16,79,45,140,s.s,37,74,102,16,30,s.s,296
CC les Villages de la Forêt,19,66,35,120,18,61,38,117,s.s,22,58,94,13,27,s.s,237
CU Angers Loire Métropole,1363,5456,2037,8856,1350,5562,2066,8978,2467,1892,3400,6145,1297,2544,89,17834
CU Caen la Mer,1319,5469,1822,8610,1156,4572,1487,7215,2148,1559,3099,5864,950,2114,91,15825
CU Clermont Auvergne Métropole,1124,4999,1697,7820,964,4730,1741,7435,2337,1636,3213,5402,927,1661,79,15255
CU Grand Paris Seine et Oise,1662,8363,3189,13214,1378,7964,2780,12122,3203,2966,5362,8090,1615,3990,110,25336
CU Orléans Métropole,1051,4941,1863,7855,1131,5031,1637,7799,2126,1767,3298,5024,1090,2251,98,15654
CU Perpignan Méditerranée Métropole,1758,6884,3255,11897,1447,6131,2820,10398,1953,2077,4955,9145,1725,2333,107,22295
CU Saint-Etienne Métropole,1828,7412,3332,12572,1608,6617,2879,11104,2266,1945,5001,9606,1392,3344,122,23676
CU Tour(S) Plus,1377,5453,2043,8873,1312,5364,1802,8478,2761,2035,3753,5850,1039,1839,74,17351
CU d'Alençon,249,909,385,1543,227,798,297,1322,s.s,236,554,1290,200,391,s.s,2865
CU d'Arras,503,2166,797,3466,420,1720,681,2821,622,648,1251,2642,406,686,32,6287
CU de Dunkerque,1263,4634,1721,7618,1075,4153,1579,6807,937,1158,3007,6494,1051,1707,71,14425
CU du Grand Dijon,1014,4583,1638,7235,893,4103,1500,6496,2077,1562,2778,4658,830,1760,66,13731
CU du Grand Reims,1308,5540,1929,8777,951,4719,1757,7427,1969,1630,3277,6038,1201,2012,77,16204
CU le Creusot Montceau-Lès-Mines,373,1486,728,2587,317,1258,740,2315,297,402,975,2306,354,552,16,4902
CU le Mans Métropole,1182,4189,1622,6993,1055,4342,1471,6868,1355,1243,2730,5336,1039,2112,46,13861
Eurométropole de Strasbourg,1992,10879,4017,16888,1740,9562,3186,14488,5665,3325,5991,10181,2113,3971,130,31376
Montpellier Méditerranée Métropole,2676,12367,4063,19106,2419,10982,3474,16875,7428,4656,8269,10090,1971,3289,278,35981
Métropole Européenne de Lille,5320,27433,10229,42982,4845,22966,8052,35863,11076,7735,16383,27646,5638,9933,434,78845
Métropole Grenoble-Alpes-Métropole,1691,7680,2758,12129,1409,6832,2422,10663,4769,2523,4465,6931,1366,2642,96,22792
Métropole Nice Côte d'Azur,2321,12058,5728,20107,1930,11369,4813,18112,6213,4505,8513,11720,2838,4288,142,38219
Métropole Rouen Normandie,2622,10116,3962,16700,2326,8787,3277,14390,3397,2831,6680,11698,2364,4029,91,31090
Métropole d'Aix-Marseille-Provence,8801,41534,18067,68402,7307,38958,15575,61840,18302,13889,27372,45986,8173,15977,543,130242
Métropole de LYON,5208,26813,9510,41531,4681,24948,7818,37447,17438,9262,15985,23121,4424,8250,498,78978
Métropole du Grand Nancy,1137,5448,1913,8498,943,4102,1462,6507,2495,1634,3066,5221,900,1612,77,15005
Métropole du Grand Paris,19632,135517,64380,219529,18006,132109,53235,203350,111610,49418,87317,93200,23901,54865,2568,422879
Nantes Métropole,2401,11833,3750,17984,2066,10932,3199,16197,7960,4641,7073,9741,1630,2924,212,34181
Rennes Métropole,1735,7398,2045,11178,1556,6653,1834,10043,5035,2870,4517,5808,1025,1784,182,21221
Toulouse Métropole,3582,16255,5232,25069,3296,16823,4925,25044,11021,6564,11069,13732,2633,4884,210,50113
Hors EPCI,865,3129,1557,5551,772,2993,1664,5429,1425,1131,2316,4439,687,927,55,10980
Total,270717,1145389,521623,1937729,238293,1116844,485372,1840509,480085,388010,782521,1398500,255890,455968,17264,3778238
