lib_epci,hommes_moins_de_25_ans,hommes_25_a_49_ans,hommes_plus_de_50_ans,total_hommes,femmes_moins_de_25_ans,femmes_25_a_49_ans,femmes_plus_de_50_ans,total_femmes,diplome_niv_1_2,diplome_niv_3,diplome_niv_4,diplome_niv_5,diplome_niv_5_bis,diplome_niv_6,diplome_indetermine,total_categorie_abc
Bordeaux Métropole,5356,26473,7792,39621,5547,28320,8488,42355,17580,11581,18125,23287,3604,7506,293,81976
Brest Métropole,1499,5987,1751,9237,1541,5923,2026,9490,3002,2245,4282,6894,903,1304,97,18727
CA Agglo Pays d'Issoire,337,1250,530,2117,348,1730,764,2842,448,572,1163,2142,s.s,350,s.s,4959
CA Agglo du Pays de Dreux,835,3258,1216,5309,776,3692,1447,5915,761,1094,2406,4653,911,1363,36,11224
CA Agglomération du Choletais,686,2361,887,3934,735,2916,1294,4945,831,1013,1956,3510,560,982,27,8879
CA Alès Agglomération,980,4197,1973,7150,834,4358,2134,7326,1080,1469,3066,6499,967,1374,21,14476
CA Amiens Métropole,1632,6734,2021,10387,1518,6023,2097,9638,2509,1855,4317,7057,1730,2486,71,20025
CA Annemasse- les Voirons-Agglomération,375,3198,1028,4601,424,2831,944,4199,1145,969,1895,3198,473,1056,64,8800
CA Annonay Rhône Agglo,340,1314,492,2146,304,1383,581,2268,396,500,1011,1817,s.s,436,s.s,4414
CA Ardenne Métropole,909,4125,1690,6724,892,3588,1636,6116,729,1087,2591,6062,962,1383,26,12840
CA Arlysère,269,1097,457,1823,261,1285,558,2104,391,429,788,1612,218,473,16,3927
CA Bassin d'Arcachon Sud-Pôle Atlantique (Cobas),402,1545,734,2681,361,2033,1099,3493,733,859,1505,2502,s.s,306,s.s,6174
"CA Beaune, Côte et Sud - Communauté Beaune-Chagny-Nolay",269,1017,441,1727,293,1306,595,2194,401,448,808,1621,s.s,417,s.s,3921
CA Bergeracoise,403,1650,673,2726,366,1799,911,3076,407,606,1249,2506,s.s,679,s.s,5802
CA Bourges Plus,657,2718,949,4324,626,2785,1189,4600,858,948,1748,3690,540,1122,18,8924
CA Cannes Pays de Lérins,1030,5522,2603,9155,939,5631,2895,9465,2305,2311,4354,6176,1280,2135,59,18620
CA Cap Excellence,868,4170,2028,7066,1070,6318,2835,10223,1129,1605,3876,6301,1626,2663,89,17289
CA Carcassonne Agglo,797,3229,1486,5512,797,3586,1755,6138,864,1227,2714,4779,763,1268,35,11650
CA Caux Vallée de Seine,694,1955,621,3270,690,2312,932,3934,364,643,1591,3441,478,673,14,7204
CA Chambéry Métropole-Coeur des Bauges,644,3308,1165,5117,664,3360,1163,5187,1801,1285,2218,3620,443,907,30,10304
CA Chartres Métropole,787,3243,1126,5156,733,3555,1404,5692,1070,1225,2291,4261,790,1174,37,10848
CA Chauny Tergnier la Fère,508,1863,729,3100,493,1801,757,3051,240,500,1251,2974,457,713,16,6151
CA Châteauroux Métropole,579,2268,837,3684,514,2161,989,3664,491,702,1508,3269,566,782,30,7348
CA Civis (Communauté Intercommunale des Villes Solidaires),2158,10721,4918,17797,2417,11838,5019,19274,1590,2225,6882,14368,3724,8248,34,37071
CA Clisson Sèvre et Maine Agglo,264,927,334,1525,298,1357,552,2207,560,569,912,1343,151,168,29,3732
CA Coeur d'Essonne Agglomération,951,3977,1510,6438,808,4671,1521,7000,1921,1754,3217,4101,887,1495,63,13438
CA Colmar Agglomération,626,3106,1132,4864,645,2848,1148,4641,948,942,1839,3925,707,1124,20,9505
CA Communauté Paris-Saclay,1079,6032,2288,9399,936,6360,2238,9534,4243,2716,4024,4841,1001,2022,86,18933
CA Concarneau Cornouaille Agglomération,297,1244,543,2084,275,1346,642,2263,518,554,1073,1745,221,219,17,4347
CA Creil Sud Oise,719,3560,1157,5436,635,3266,941,4842,758,971,2319,3458,927,1809,36,10278
CA Dinan Agglomération,564,2292,950,3806,620,2679,1209,4508,835,956,1973,3695,420,418,17,8314
CA Dracénoise,753,2768,1256,4777,723,3149,1481,5353,803,1072,2233,4385,697,917,23,10130
CA Durance-Lubéron-Verdon Agglomération,467,1872,853,3192,435,2156,947,3538,665,729,1427,2800,431,665,13,6730
CA Ecla (Espace Communautaire Lons Agglomération),215,753,278,1246,206,695,326,1227,208,242,524,1059,s.s,275,s.s,2473
"CA Epernay, Coteaux et Plaine de Champagne",342,1314,393,2049,314,1384,495,2193,276,377,845,1868,304,548,24,4242
CA Etampois Sud Essonne,271,1151,486,1908,277,1250,425,1952,374,456,895,1408,246,466,15,3860
CA Evreux Portes de Normandie,790,3120,1198,5108,754,3245,1223,5222,799,946,2283,4173,862,1228,39,10330
CA Flers Agglo,411,1325,485,2221,390,1428,573,2391,267,413,952,2203,256,502,19,4612
CA Fougères Agglomération,369,1120,414,1903,350,1335,519,2204,332,452,926,1796,247,335,19,4107
CA Fécamp Caux Littoral Agglomération,365,987,417,1769,370,1089,525,1984,203,305,732,1841,s.s,433,s.s,3753
CA Gap-Tallard-Durance,301,1281,473,2055,276,1302,596,2174,502,512,995,1669,234,306,11,4229
CA Golfe du Morbihan - Vannes Agglomération,904,4026,1450,6380,937,4646,1971,7554,2310,2156,3301,4924,567,631,45,13934
CA Grand Auch Coeur de Gascogne,220,871,363,1454,234,891,380,1505,307,339,687,1218,s.s,255,s.s,2959
CA Grand Belfort,589,2869,1064,4522,579,2784,1176,4539,922,961,1870,3695,604,963,46,9061
CA Grand Lac- Communauté d'Agglomération du Lac du Bourget,361,1507,640,2508,346,1774,807,2927,904,792,1189,1933,243,362,12,5435
CA Grand Montauban,590,2596,908,4094,622,2851,1021,4494,806,833,1889,3058,610,1364,28,8588
CA Grand Paris Sud Seine Essonne Sénart,1752,9571,3477,14800,1851,10284,3122,15257,3745,3498,7526,8720,2135,4262,171,30057
CA Grand Sud Caraïbe,715,3184,2133,6032,837,4348,2525,7710,608,1054,2817,5371,1376,2463,53,13742
CA Grand-Poitiers,1232,5040,1382,7654,1189,4839,1580,7608,2504,1994,3510,5431,636,1135,52,15262
CA Guingamp-Paimpol Armor-Argoat Agglomération,390,1723,820,2933,472,1899,988,3359,560,679,1472,2785,370,409,17,6292
"CA Havraise (Co,D,A,H,)",2391,8753,2817,13961,2220,7789,3192,13201,2291,2354,5922,12077,1647,2795,76,27162
CA Hermitage-Tournonais-Herbasse-Pays de Saint Félicien,373,1527,597,2497,402,1726,715,2843,553,635,1151,2045,305,637,14,5340
CA Hérault-Méditerranée,744,3050,1458,5252,726,3168,1577,5471,795,1093,2442,4696,731,944,22,10723
CA Intercommunale de la Réunion Est (Cirest),1502,6653,2862,11017,1485,6846,2710,11041,639,1243,4343,9352,1988,4443,50,22058
CA Intercommunale du Nord de la Réunion (Cinor),2108,9986,4231,16325,2303,10941,4248,17492,2264,2421,7100,12211,3123,6633,65,33817
CA Lannion-Trégor Communauté,550,2183,1004,3737,470,2390,1207,4067,983,995,1808,3189,411,397,21,7804
CA Limoges Métropole,1366,5747,1717,8830,1383,5489,1910,8782,2223,1870,3848,6461,1036,2136,38,17612
CA Lisieux Normandie,584,1687,662,2933,517,1751,789,3057,309,443,1133,2912,412,763,18,5990
CA Loire Forez,585,1959,833,3377,617,2495,1173,4285,665,816,1880,3347,356,582,16,7662
CA Lorient Agglomération,1331,5432,2095,8858,1374,5678,2620,9672,2320,2305,4318,7478,914,1143,52,18530
CA Luberon Monts de Vaucluse,453,1882,840,3175,437,2033,948,3418,564,687,1344,2259,462,1265,12,6593
CA Marne et Gondoire,382,2037,759,3178,376,2348,836,3560,1283,1073,1596,1875,376,514,21,6738
CA Maubeuge Val de Sambre,1423,5491,1801,8715,1247,4870,1722,7839,742,1254,3932,7778,1141,1681,26,16554
CA Mauges Communauté,567,1971,777,3315,800,2906,1317,5023,651,956,1964,3570,506,674,17,8338
CA Melun Val de Seine,742,3951,1395,6088,753,3776,1166,5695,1303,1331,2856,3650,789,1803,51,11783
CA Metz Métropole,1372,7379,2523,11274,1259,6444,2615,10318,3009,2384,4336,7598,1337,2853,75,21592
CA Mont de Marsan Agglomération,308,1305,498,2111,345,1499,584,2428,420,524,998,1807,263,517,10,4539
CA Mont-Saint-Michel-Normandie,460,1529,688,2677,468,1707,799,2974,425,583,1160,2568,345,536,34,5651
"CA Montargoise et Rives du Loing (A,M,E,)",516,2074,827,3417,548,2196,824,3568,473,564,1322,2870,618,1101,37,6985
CA Montluçon Communauté,473,1706,772,2951,397,1816,878,3091,414,520,1206,2851,409,629,13,6042
CA Montélimar Agglomération,479,1909,796,3184,527,2211,953,3691,639,781,1457,2778,413,785,22,6875
CA Morlaix Communauté,430,1579,645,2654,372,1716,765,2853,595,656,1330,2345,264,303,14,5507
CA Moulins Communauté,434,1556,638,2628,377,1627,756,2760,352,486,1032,2449,428,622,19,5388
CA Mulhouse Alsace Agglomération,1874,9544,3571,14989,1549,7782,3219,12550,2271,2503,5583,11585,1709,3778,110,27539
CA Mâconnais Beaujolais Agglomération,515,2169,719,3403,529,2170,873,3572,627,725,1470,2758,478,893,24,6975
CA Paris - Vallée de la Marne,1067,5407,2091,8565,1017,5852,2038,8907,2616,2303,4231,5177,1091,2006,48,17472
CA Pau Béarn Pyrénées,970,4242,1648,6860,955,4819,2063,7837,2439,1922,3236,5365,575,1123,37,14697
CA Pays Foix-Varilhes,189,837,353,1379,206,979,391,1576,335,310,700,1212,s.s,250,s.s,2955
CA Pays de Montbéliard Agglomération,874,4129,1471,6474,771,3805,1758,6334,822,1230,2660,5639,883,1548,26,12808
CA Plaine Vallée,827,3939,1751,6517,674,4264,1765,6703,2449,1951,3061,3653,753,1316,37,13220
CA Pornic Agglo Pays de Retz,351,1125,505,1981,371,1480,781,2632,523,672,1160,1855,201,187,15,4613
"CA Porte de l'Isère (C,A,P,I)",727,3069,969,4765,801,3496,1182,5479,992,1094,2297,3940,728,1135,58,10244
CA Portes de France-Thionville,422,2086,811,3319,372,1962,872,3206,779,730,1359,2658,340,636,23,6525
CA Privas Centre Ardèche,306,1082,478,1866,312,1186,538,2036,366,444,880,1573,223,398,18,3902
CA Provence-Alpes-Agglomération,326,1413,623,2362,307,1414,694,2415,414,492,1028,2072,300,459,12,4777
CA Quimper Bretagne Occidentale,662,2886,928,4476,672,2809,1034,4515,1207,1192,2130,3388,456,581,37,8991
CA Rambouillet Territoires,271,1126,527,1924,215,1277,613,2105,976,701,847,1080,166,240,19,4029
CA Roannais Agglomération,626,2434,1062,4122,676,2657,1337,4670,685,833,1835,3971,514,933,21,8792
CA Rochefort Océan,436,1787,783,3006,429,1992,1029,3450,538,681,1349,3077,342,459,10,6456
CA Rodez Agglomération,318,1146,361,1825,330,1236,480,2046,458,501,854,1480,203,360,15,3871
CA Roissy Pays de France,2255,10504,4362,17121,2241,10715,3899,16855,3185,3435,8454,10316,2714,5764,108,33976
CA Royan Atlantique,534,1992,954,3480,487,2252,1486,4225,638,860,1732,3486,462,514,13,7705
CA Saint Germain Boucles de Seine,916,6243,3046,10205,840,6948,3054,10842,5841,2985,4141,4920,1013,2038,109,21047
CA Saint-Brieuc Armor Agglomération,956,3991,1471,6418,1019,4262,1748,7029,1442,1566,3119,5443,785,1044,48,13447
CA Saint-Louis Agglomération,286,1821,974,3081,320,1603,795,2718,676,633,1180,2350,306,632,22,5799
CA Saint-Lô Agglo,461,1595,533,2589,498,1737,677,2912,386,526,1163,2538,321,556,11,5501
CA Sarreguemines Confluences,416,1647,800,2863,365,1562,806,2733,339,485,1136,2512,359,753,12,5596
CA Saumur Val de Loire,840,2709,1098,4647,822,3211,1556,5589,666,816,1891,4398,944,1500,21,10236
CA Seine Eure,599,2037,754,3390,572,2211,830,3613,487,649,1543,2912,568,811,33,7003
CA Seine Normandie Agglomération,607,2145,843,3595,558,2276,1065,3899,684,774,1702,2934,531,845,24,7494
CA Sud Sainte Baume,356,1259,656,2271,277,1547,870,2694,682,707,1217,1883,270,196,10,4965
CA Tarbes-Lourdes-Pyrénées,914,3743,1706,6363,864,4003,2147,7014,1135,1402,2884,5923,836,1176,21,13377
CA Terre de Provence,413,1516,817,2746,380,1757,813,2950,523,574,1203,2118,366,902,10,5696
CA Territoire de la Côte Ouest (Tco),2471,12662,5475,20608,2757,13542,5315,21614,2195,2792,7254,16237,4225,9468,51,42222
CA Territoires Vendômois,383,1193,545,2121,291,1294,666,2251,368,434,867,1916,s.s,481,s.s,4372
CA Thonon Agglomération,359,2050,824,3233,337,2081,835,3253,904,783,1331,2507,313,621,27,6486
CA Toulon Provence Méditerranée,2692,11905,4914,19511,2656,11984,5311,19951,4277,4589,9036,15352,2693,3400,115,39462
CA Troyes Champagne Métropole,1196,5667,2147,9010,1383,5973,2245,9601,1500,1706,3553,7612,1504,2689,47,18611
CA Tulle Agglo,218,849,366,1433,203,1024,464,1691,285,300,711,1338,188,286,16,3124
CA Val Parisis,1167,6166,2493,9826,1044,6378,2552,9974,3347,2787,4672,5763,1186,1955,90,19800
CA Val d'Europe Agglomération,134,575,216,925,123,852,252,1227,437,387,584,522,93,118,11,2152
CA Val d'Yerres Val de Seine,825,3744,1480,6049,755,4200,1411,6366,1917,1639,3063,3616,826,1310,44,12415
CA Val de Garonne Agglomération,368,1558,627,2553,383,1769,828,2980,338,471,1045,2371,416,877,15,5533
CA Valence Romans Agglo,1515,6668,2615,10798,1613,7004,2854,11471,2529,2554,4737,8382,1426,2563,78,22269
CA Valenciennes Métropole,1870,7507,2433,11810,1710,6283,2309,10302,1641,1978,4950,9672,1449,2371,51,22112
CA Var Esterel Méditerranée (Cavem),722,3318,1525,5565,717,3513,1789,6019,1080,1444,2650,4565,778,1049,18,11584
CA Ventoux-Comtat-Venaissin (Cove),524,2347,1033,3904,506,2434,1118,4058,598,784,1638,3122,520,1280,20,7962
"CA Versailles Grand Parc (C,A,V,G,P,)",628,4021,1844,6493,522,4692,1820,7034,4625,2123,2493,2764,473,971,78,13527
CA Vichy Communauté,518,2136,960,3614,540,2239,1180,3959,661,795,1596,3259,635,616,11,7573
CA Viennagglo,411,1658,584,2653,435,1823,686,2944,629,673,1186,2129,381,578,21,5597
CA Villefranche Beaujolais Saône,411,2099,746,3256,427,2121,716,3264,699,694,1377,2434,418,853,45,6520
CA Vitré Communauté,473,1486,468,2427,535,1941,811,3287,586,716,1331,2359,295,399,28,5714
CA d'Agen,588,2596,958,4142,640,2758,1124,4522,784,985,1955,3532,506,873,29,8664
CA d'Arles-Crau-Camargue-Montagnette,762,3039,1499,5300,651,3131,1460,5242,918,952,2267,3912,682,1779,32,10542
CA d'Epinal,742,2884,1209,4835,709,2803,1426,4938,645,910,2042,4508,634,994,40,9773
CA d'hénin-Carvin,1291,4600,1564,7455,1184,4068,1357,6609,671,1287,3506,6395,918,1259,28,14064
CA de Bar-Le-Duc - Sud Meuse,223,896,369,1488,196,776,379,1351,193,261,605,1305,s.s,316,s.s,2839
CA de Bastia,246,1068,440,1754,230,1135,445,1810,442,348,846,1147,326,440,15,3564
CA de Blois ''agglopolys'',676,3024,1163,4863,622,2920,1187,4729,937,1011,1951,3691,735,1218,49,9592
"CA de Béthune-Bruay, Artois-Lys Romane",2450,7752,2563,12765,2205,7791,2926,12922,1262,2486,6250,12015,1500,2135,39,25687
CA de Béziers-Méditerranée,1060,4889,1938,7887,1032,4339,1915,7286,1089,1401,3242,6467,1228,1722,24,15173
CA de Cambrai,766,2625,1070,4461,694,2695,1174,4563,609,897,2088,3980,505,934,11,9024
CA de Castres Mazamet,620,2031,889,3540,641,2277,1097,4015,589,767,1747,3258,486,697,11,7555
CA de Cergy-Pontoise,1117,6236,2085,9438,1079,6561,2159,9799,2845,2485,4529,5610,1231,2427,110,19237
"CA de Chaumont, du Bassin Nogentais et du Bassin de Bologne Vignory Froncles",244,898,386,1528,278,986,458,1722,205,292,705,1429,s.s,379,s.s,3250
CA de Châlons-En-Champagne,519,2147,672,3338,537,2114,716,3367,437,597,1370,3051,436,804,10,6705
CA de Forbach Porte de France,512,2544,1027,4083,447,2230,1197,3874,435,623,1581,3513,666,1126,13,7957
CA de Haguenau,558,2002,889,3449,587,2197,859,3643,557,726,1436,3014,476,869,14,7092
CA de Laval,545,2366,718,3629,598,2422,778,3798,842,851,1624,2758,438,895,19,7427
CA de Lens - Liévin,2571,8726,2804,14101,2233,7140,2544,11917,1205,2256,6345,12087,1548,2515,62,26018
CA de Longwy,298,1844,661,2803,245,1383,554,2182,377,452,1086,2106,292,654,18,4985
CA de Nevers,388,1545,541,2474,403,1409,637,2449,332,419,1087,2278,287,504,16,4923
CA de Nîmes Métropole,2072,9223,3925,15220,1908,8410,3637,13955,2815,3114,6232,10573,2305,4008,128,29175
CA de Saint Quentin en Yvelines,1016,5282,1949,8247,942,5476,1912,8330,2789,2244,3616,4710,951,2215,52,16577
CA de Saint-Dizier Der et Blaise,409,1610,677,2696,403,1713,804,2920,217,394,1143,2821,405,620,16,5616
CA de Saint-Dié-Des-Vosges,593,2107,1090,3790,567,2063,1214,3844,349,624,1617,3520,680,827,17,7634
CA de Saintes,398,1444,612,2454,380,1677,916,2973,454,613,1249,2429,s.s,354,s.s,5427
CA de Sophia Antipolis,920,4710,2287,7917,845,5111,2619,8575,2858,2236,3749,5195,1020,1393,41,16492
CA de Vesoul,223,866,303,1392,201,789,376,1366,212,230,540,1272,s.s,321,s.s,2758
CA de l'Albigeois (C2a),568,2100,751,3419,570,2324,924,3818,869,849,1693,2799,416,597,14,7237
CA de l'Auxerrois,439,1684,598,2721,411,1605,726,2742,447,544,1137,2327,340,636,32,5463
CA de l'Espace Sud de la Martinique,771,3805,2506,7082,805,5709,3185,9699,1205,1554,3436,6836,1415,2281,54,16781
CA de l'Ouest Rhodanien,278,1044,447,1769,266,1072,502,1840,297,319,781,1593,261,347,11,3609
CA de la Baie de Somme,481,1479,558,2518,471,1414,682,2567,227,357,1021,2399,445,625,11,5085
CA de la Porte du Hainaut,1559,6030,1999,9588,1383,5473,1975,8831,1007,1460,4264,8517,1160,1975,36,18419
CA de la Presqu'île de Guérande Atlantique (Cap Atlantique),470,1505,773,2748,455,1913,1110,3478,857,834,1509,2498,278,214,36,6226
CA de la Provence Verte,702,2363,1088,4153,623,2938,1343,4904,818,1150,2168,3732,573,587,29,9057
CA de la Riviera Française,311,1875,844,3030,351,1970,978,3299,802,778,1621,2117,456,539,16,6329
CA de la Rochelle,1174,5027,1750,7951,1104,5101,2192,8397,2518,2206,3546,6276,766,995,41,16348
CA de la Région Dieppoise,468,1513,607,2588,427,1410,718,2555,271,367,1083,2398,369,643,12,5143
CA de la Région Nazairienne et de l'Estuaire (Carene),995,3562,1317,5874,1017,3799,1579,6395,1185,1355,2782,5409,661,838,39,12269
CA de la Région de Château-Thierry,484,1549,596,2629,421,1651,766,2838,267,466,1135,2511,413,654,21,5467
CA de la Région de Compiègne et de la Basse Automne,482,2388,775,3645,539,2435,916,3890,909,751,1622,2853,525,847,28,7535
CA des Deux Baies en Montreuillois,585,1746,737,3068,511,1593,716,2820,427,575,1513,2576,343,436,18,5888
CA du Bassin d'Aurillac,268,940,380,1588,241,1040,563,1844,293,347,735,1540,s.s,274,s.s,3432
CA du Bassin de Bourg-En-Bresse,778,2800,1043,4621,696,3066,1164,4926,909,1059,2146,3822,567,995,49,9547
CA du Bassin de Brive,583,2403,970,3956,655,3045,1384,5084,778,1027,2062,3752,471,932,18,9040
CA du Bassin de Thau,997,4278,1940,7215,912,4198,2042,7152,1289,1542,3338,6088,929,1133,48,14367
CA du Beauvaisis,833,3078,1011,4922,863,3232,1124,5219,737,879,2029,4216,929,1325,26,10141
CA du Bocage Bressuirais,503,1483,662,2648,509,1738,734,2981,364,559,1285,2477,306,617,21,5629
CA du Boulonnais,1164,4100,1313,6577,1143,3634,1490,6267,744,1072,2735,5713,1201,1342,37,12844
CA du Calaisis,1197,3998,1332,6527,1048,3177,1362,5587,598,924,2802,5725,713,1309,43,12114
CA du Centre Littoral,868,3449,1699,6016,1066,5880,1877,8823,887,941,2638,4353,1269,4663,88,14839
CA du Centre de la Martinique,1027,5204,2834,9065,1197,7545,3865,12607,1943,2211,4669,7920,1751,3129,49,21672
CA du Cotentin,808,2617,1010,4435,885,3143,1424,5452,806,903,2078,4671,656,733,40,9887
"CA du Douaisis [c,A,D,]",1702,5868,1977,9547,1515,5038,1849,8402,1007,1575,4379,8014,1132,1781,61,17949
CA du Gard Rhodanien,532,2042,895,3469,522,2159,995,3676,622,753,1651,2849,399,831,40,7145
CA du Grand Angoulême,919,4344,1494,6757,1028,4353,1923,7304,1591,1547,3103,5748,743,1291,38,14061
CA du Grand Annecy,733,3700,1165,5598,704,4051,1278,6033,2599,1635,2408,3538,499,861,91,11631
CA du Grand Avignon (Coga),1470,7204,2703,11377,1461,6954,2670,11085,2603,2380,4855,8078,1351,3134,61,22462
CA du Grand Besançon,1198,5286,1739,8223,1058,4909,1890,7857,2642,1838,3437,5564,844,1688,67,16080
CA du Grand Cahors,265,1206,504,1975,226,1245,637,2108,380,420,937,1619,269,446,12,4083
CA du Grand Cognac,468,1620,652,2740,480,2012,953,3445,501,579,1319,2852,359,564,11,6185
CA du Grand Dax,384,1589,674,2647,424,1825,907,3156,452,655,1259,2600,323,504,10,5803
CA du Grand Dole,323,1138,420,1881,284,1392,572,2248,343,456,917,1825,231,346,11,4129
CA du Grand Guéret,194,711,263,1168,176,602,288,1066,136,197,482,1060,s.s,219,s.s,2234
CA du Grand Sénonais,390,1719,618,2727,370,1679,709,2758,388,463,1073,2423,425,700,13,5485
CA du Grand Verdun,214,727,308,1249,192,695,298,1185,116,213,484,1178,152,278,13,2434
CA du Grand Villeneuvois,330,1355,589,2274,328,1446,652,2426,244,371,1026,2037,s.s,683,s.s,4700
CA du Libournais,685,2606,1038,4329,713,3242,1288,5243,632,818,1981,4263,650,1210,18,9572
CA du Niortais,772,2837,1042,4651,763,3087,1128,4978,1076,1211,2112,4054,429,712,35,9629
CA du Nord Basse-Terre,602,2644,1624,4870,737,4138,2097,6972,780,1208,2491,4506,1043,1780,34,11842
CA du Nord Grande Terre,508,2464,1454,4426,598,3335,1740,5673,461,851,2025,3951,1032,1740,39,10099
CA du Pays Ajaccien,382,1560,705,2647,403,1801,731,2935,667,571,1330,1871,472,649,22,5582
CA du Pays Basque,1656,7885,2827,12368,1629,9087,3635,14351,4366,4078,6212,9644,1006,1341,72,26719
CA du Pays Châtelleraudais,590,1901,819,3310,549,2254,1027,3830,450,639,1473,3485,382,696,15,7140
CA du Pays Nord Martinique,825,3154,2221,6200,889,4660,2987,8536,692,1139,2990,6047,1265,2572,31,14736
CA du Pays Voironnais,504,1797,709,3010,452,2019,911,3382,953,867,1380,2323,379,464,26,6392
CA du Pays de Fontainebleau,257,1208,521,1986,229,1326,625,2180,922,631,938,1117,206,329,23,4166
CA du Pays de Grasse,604,2463,1146,4213,593,2893,1406,4892,1088,1126,2041,3320,622,883,25,9105
CA du Pays de Laon,460,1550,525,2535,376,1429,623,2428,268,347,953,2201,423,761,10,4963
CA du Pays de Meaux,607,2691,901,4199,603,2839,940,4382,814,919,2025,3006,702,1066,49,8581
CA du Pays de Quimperlé,348,1218,559,2125,283,1428,650,2361,503,602,1155,1811,217,174,24,4486
CA du Pays de Saint Malo - Saint Malo Agglomération,547,2132,755,3434,567,2196,1085,3848,943,843,1654,2987,398,414,43,7282
CA du Pays de Saint-Omer,880,2879,921,4680,849,3000,1258,5107,591,1024,2152,4420,588,992,20,9787
CA du Pays de l'Or,354,1665,751,2770,356,1672,814,2842,780,832,1348,1959,306,359,28,5612
CA du Puy-En-Velay,442,1757,820,3019,455,1916,961,3332,593,795,1452,2637,345,507,22,6351
CA du Rabastinois - Tarn et Dadou - Vère Grésigne et Pays Salvagnacois,501,1972,824,3297,436,2340,994,3770,764,850,1615,2770,417,638,13,7067
CA du Saint-Quentinois,854,3220,1047,5121,815,2812,1151,4778,473,712,1915,4565,895,1317,22,9899
CA du Sicoval,346,1535,561,2442,334,2026,748,3108,1280,931,1298,1516,226,281,18,5550
CA du Soissonnais,454,1986,807,3247,428,1735,769,2932,337,521,1225,2765,506,807,18,6179
CA du Sud,1512,7600,3629,12741,1704,8804,3924,14432,917,1514,5109,10408,2892,6313,20,27173
CA du Val de Fensch,485,2157,827,3469,475,2013,868,3356,407,651,1471,3136,362,777,21,6825
CA la Riviéra du Levant,540,2726,1516,4782,572,3755,1911,6238,890,1095,2398,3876,1159,1552,50,11020
CA la Roche Sur Yon - Agglomération,772,2552,850,4174,751,2808,1121,4680,904,1009,2036,3521,481,880,23,8854
CA le Grand Chalon,699,3032,1158,4889,692,3112,1417,5221,868,1090,2099,4311,604,1125,13,10110
CA le Grand Narbonne,1114,4246,1875,7235,1006,4408,2322,7736,1144,1499,3512,6524,1039,1182,71,14971
CA le Grand Périgueux,702,2638,1065,4405,641,2706,1160,4507,756,966,2026,3742,541,858,23,8912
CA le Muretain Agglo,762,2653,1157,4572,739,3677,1437,5853,1243,1429,2514,3890,565,764,20,10425
CA les Sables d'Olonne Agglomération,319,1164,609,2092,335,1297,872,2504,448,550,1090,1916,s.s,335,s.s,4596
CC Adour Madiran,124,487,279,890,129,549,289,967,121,218,383,904,s.s,119,s.s,1857
CC Agglo Saint-Avold Centre Mosellan,386,1520,563,2469,346,1433,707,2486,285,454,1109,2219,355,508,25,4955
CC Agly Fenouillèdes,33,215,82,330,32,205,93,330,50,56,149,279,s.s,65,s.s,660
CC Airvaudais-Val du Thouet,41,127,70,238,34,160,78,272,27,46,103,263,20,51,",",510
CC Albret Communauté,142,622,306,1070,146,712,400,1258,179,232,468,954,s.s,345,s.s,2328
CC Alpes d'Azur,42,194,112,348,31,235,119,385,47,81,165,311,s.s,65,s.s,733
"CC Alpes-Provence-Verdon ""sources de Lumière""",50,277,167,494,48,316,197,561,102,112,247,448,s.s,71,s.s,1055
CC Altitude 800,12,83,32,127,21,121,38,180,17,35,72,149,16,18,",",307
CC Ambert Livradois Forez,118,515,335,968,119,554,351,1024,178,229,447,835,s.s,179,s.s,1992
CC Amognes Coeur du Nivernais,40,119,93,252,28,137,91,256,33,37,97,258,s.s,49,s.s,508
CC Andaine - Passais,73,219,106,398,81,241,123,445,70,70,183,377,s.s,82,s.s,843
CC Anjou Bleu Communauté,260,698,274,1232,247,778,300,1325,193,225,632,1053,s.s,253,s.s,2557
CC Anjou Loir et Sarthe,175,562,242,979,194,816,332,1342,187,223,485,1039,s.s,215,s.s,2321
"CC Arbois, Poligny, Salins, Coeur du Jura",102,337,166,605,101,369,223,693,117,153,280,597,s.s,93,s.s,1298
CC Arc Sud Bretagne,100,531,291,922,148,711,359,1218,233,294,498,903,104,96,12,2140
"CC Ardenne, Rives de Meuse",203,793,382,1378,156,805,443,1404,118,215,512,1315,238,373,11,2782
CC Ardennes Thiérache,81,203,93,377,52,221,93,366,26,66,141,339,s.s,94,s.s,743
CC Ardèche Rhône Coiron,182,642,266,1090,188,746,288,1222,182,219,516,1020,s.s,201,s.s,2312
CC Ardèche des Sources et Volcans,51,261,130,442,62,310,179,551,91,101,257,422,s.s,65,s.s,993
CC Argentan Intercom,195,692,272,1159,210,745,330,1285,133,173,470,1196,s.s,289,s.s,2444
CC Argonne-Meuse,31,124,66,221,42,131,54,227,18,36,109,213,s.s,43,s.s,448
CC Arize Lèze,48,285,131,464,50,326,157,533,154,126,214,395,s.s,58,s.s,997
CC Armagnac Adour,30,124,60,214,23,149,77,249,26,42,119,207,33,36,",",463
CC Arnon Boischaut Cher,49,154,89,292,45,170,126,341,33,55,130,319,s.s,52,s.s,633
CC Artagnan de Fezensac,25,100,74,199,31,124,80,235,41,43,103,177,32,38,",",434
CC Arve et Salève,67,364,154,585,65,406,153,624,201,180,230,467,s.s,75,s.s,1209
CC Astarac Arros en Gascogne,30,109,77,216,24,132,85,241,40,52,109,200,22,34,",",457
CC Au Pays de la Roche Aux Fées,155,469,159,783,130,632,229,991,165,228,403,753,s.s,110,s.s,1774
CC Aubrac Lot Causse et Pays de Chanac,36,125,60,221,34,157,52,243,65,65,128,166,s.s,24,s.s,464
CC Aubrac et Carladez,18,70,44,132,27,125,88,240,40,41,78,151,31,31,",",372
CC Aunis Atlantique,182,643,207,1032,166,872,334,1372,192,273,565,1153,s.s,112,s.s,2404
CC Aunis Sud,215,742,297,1254,216,899,378,1493,220,313,545,1340,s.s,182,s.s,2747
CC Auray Quiberon Terre Atlantique,526,2176,943,3645,545,2484,1282,4311,1058,1157,1997,3085,334,304,21,7956
CC Aure Louron,42,243,52,337,39,277,99,415,93,124,216,265,s.s,23,s.s,752
CC Auxonne Pontailler Val de Saône,148,440,197,785,139,653,270,1062,89,163,361,895,s.s,203,s.s,1847
CC Auzon Communauté,57,229,99,385,75,261,142,478,42,68,195,455,s.s,49,s.s,863
"CC Avallon, Vézelay, Morvan",105,402,169,676,92,423,212,727,99,125,266,687,s.s,134,s.s,1403
CC Aveyron Ségala Viaur,22,82,46,150,27,113,52,192,38,30,91,154,15,14,",",342
CC Avre Luce Noye,155,493,161,809,138,550,237,925,104,178,381,765,s.s,161,s.s,1734
CC Aygues-Ouvèze en Provence (Ccaop),122,415,184,721,109,618,283,1010,130,232,411,687,s.s,160,s.s,1731
CC Bassée-Montois,106,332,200,638,104,467,260,831,95,168,352,650,s.s,93,s.s,1469
CC Bastides de Lomagne,36,148,101,285,34,240,101,375,77,86,133,285,42,37,",",660
CC Bastides et Vallons du Gers,35,124,68,227,17,139,99,255,35,51,109,224,30,33,",",482
CC Baugeois Vallée,198,705,289,1192,242,914,433,1589,186,253,609,1248,185,288,12,2781
CC Bazois Loire Morvan,49,224,182,455,60,244,207,511,53,85,195,461,s.s,107,s.s,966
CC Beaucaire Terre d'Argence,304,1373,622,2299,294,1344,522,2160,234,340,906,1523,373,1064,19,4459
CC Beauce Val de Loire,108,416,160,684,115,465,219,799,84,146,326,685,107,125,10,1483
CC Beaujolais Pierres Dorées,168,704,330,1202,168,919,369,1456,523,445,599,843,109,121,18,2658
CC Berg et Coiron,59,198,73,330,65,252,97,414,98,90,181,288,s.s,44,s.s,744
CC Berry Grand Sud,70,228,169,467,44,217,186,447,40,56,185,465,s.s,110,s.s,914
CC Berry Loire Puisaye,130,393,227,750,116,525,269,910,66,132,312,826,s.s,178,s.s,1660
CC Berry-Loire-Vauvise,36,114,57,207,30,123,69,222,15,28,92,214,36,44,",",429
CC Billom Communauté,134,526,194,854,121,644,237,1002,179,256,422,756,s.s,131,s.s,1856
CC Bièvre Isère,291,914,459,1664,296,1451,606,2353,347,469,872,1740,263,310,16,4017
CC Blangy-Pont l'Evêque Intercom,82,281,144,507,77,356,180,613,104,143,231,480,s.s,91,s.s,1120
CC Bouzonvillois-Trois Frontières,110,446,216,772,108,438,225,771,104,139,369,685,s.s,147,s.s,1543
CC Brenne - Val de Creuse,99,308,159,566,110,333,173,616,58,91,261,566,s.s,130,s.s,1182
CC Bresse Haute Seille,86,278,143,507,72,360,174,606,99,140,217,529,s.s,72,s.s,1113
CC Bresse Louhannaise Intercom',150,479,222,851,176,600,313,1089,103,163,370,953,s.s,219,s.s,1940
CC Bresse Revermont 71,49,150,75,274,54,204,103,361,29,66,123,302,s.s,63,s.s,635
CC Bretagne Porte de Loire Communauté,161,580,201,942,168,853,241,1262,241,267,566,898,108,111,13,2204
CC Bretagne Romantique,177,702,254,1133,189,964,337,1490,338,320,619,1087,103,146,10,2623
CC Briance Combade,25,91,56,172,28,118,63,209,36,34,91,177,19,24,",",381
CC Briance Sud Haute Vienne,33,146,76,255,32,196,94,322,60,70,125,261,28,33,",",577
CC Brie Nangissienne,155,485,196,836,166,580,271,1017,120,201,450,731,s.s,203,s.s,1853
CC Brie des Rivières et Châteaux,138,530,258,926,132,653,232,1017,205,269,505,698,s.s,154,s.s,1943
CC Bruyères-Vallons des Vosges,113,329,164,606,95,376,202,673,50,112,256,652,s.s,104,s.s,1279
CC Bugey Sud,183,781,334,1298,173,805,371,1349,246,267,569,1187,135,219,24,2647
CC Buëch-Dévoluy,45,244,100,389,43,245,105,393,88,115,182,308,s.s,46,s.s,782
CC Cagire Garonne Salat,77,373,208,658,83,417,243,743,146,150,326,615,s.s,76,s.s,1401
CC Campagne-De-Caux,115,212,93,420,93,330,182,605,58,127,249,458,s.s,82,s.s,1025
CC Canaux et Forêts en Gâtinais,154,550,319,1023,153,665,302,1120,120,209,434,970,s.s,216,s.s,2143
CC Cap Sizun - Pointe du Raz,66,257,165,488,68,296,215,579,125,139,249,466,s.s,34,s.s,1067
CC Capcir Haut Conflent,43,184,75,302,43,224,99,366,77,81,181,264,29,36,",",668
CC Carmausin-Ségala,220,749,340,1309,193,824,408,1425,205,228,598,1290,s.s,222,s.s,2734
CC Carnelle Pays-De-France,126,440,223,789,132,510,242,884,255,253,420,551,s.s,94,s.s,1673
CC Castelnaudary Lauragais Audois,152,663,250,1065,145,839,347,1331,239,253,592,978,s.s,187,s.s,2396
CC Castillon/Pujols,141,536,287,964,158,666,293,1117,118,162,388,842,s.s,395,s.s,2081
CC Causses Aigoual Cévennes,27,153,105,285,22,176,81,279,83,71,141,211,31,27,",",564
CC Causses et Vallée de la Dordogne,242,982,501,1725,248,1169,657,2074,322,404,868,1684,228,283,10,3799
CC Caux - Austreberthe,231,612,218,1061,217,689,285,1191,122,206,485,1034,s.s,230,s.s,2252
CC Caux Estuaire,112,249,121,482,109,359,180,648,99,149,274,485,s.s,68,s.s,1130
CC Cazals-Salviac,29,103,55,187,29,127,73,229,45,50,100,181,s.s,20,s.s,416
CC Centre Morbihan Communauté,223,879,352,1454,240,1184,449,1873,264,360,799,1488,183,216,17,3327
CC Centre Tarn,63,207,114,384,58,271,152,481,69,105,211,359,s.s,72,s.s,865
"CC Chablis, Villages et Terroirs",74,238,106,418,73,298,135,506,60,106,191,425,s.s,97,s.s,924
CC Chabris - Pays de Bazelle,38,118,68,224,27,123,84,234,14,37,83,242,s.s,53,s.s,458
CC Challans-Gois Communauté,283,925,415,1623,326,1328,677,2331,257,393,917,1907,s.s,251,s.s,3954
CC Chalosse Tursan,148,453,236,837,149,582,342,1073,126,228,421,888,s.s,137,s.s,1910
CC Champagnole Nozeroy Jura,110,375,185,670,82,422,240,744,110,125,314,626,s.s,150,s.s,1414
CC Champsaur-Valgaudemar,52,293,116,461,47,307,149,503,117,126,280,364,s.s,31,s.s,964
CC Charente-Arnoult-Coeur de Saintonge,101,368,162,631,95,474,229,798,109,157,306,691,s.s,82,s.s,1429
CC Charlieu-Belmont,132,398,215,745,129,485,310,924,97,162,349,814,s.s,136,s.s,1669
CC Chavanon Combrailles et Volcans,62,184,101,347,56,243,112,411,49,87,190,338,s.s,51,s.s,758
"CC Chinon, Vienne et Loire",151,502,198,851,137,550,295,982,152,179,423,794,s.s,175,s.s,1833
CC Châteaubriant-Derval,276,975,367,1618,323,1150,446,1919,256,353,778,1648,s.s,278,s.s,3537
"CC Chénérailles, Auzances/Bellegarde et Haut Pays Marchois",41,247,151,439,50,242,164,456,65,83,185,428,s.s,80,s.s,895
"CC Ciate, Bourganeuf/Royère-De-Vassivière",76,294,160,530,69,308,190,567,92,97,222,529,s.s,110,s.s,1097
CC Cingal-Suisse Normande,155,534,183,872,121,666,219,1006,156,200,409,833,s.s,177,s.s,1878
CC Cluses-Arve et Montagnes,271,1246,460,1977,272,1495,606,2373,319,430,854,1605,s.s,801,s.s,4350
CC Coeur Côte Fleurie,123,496,227,846,136,530,363,1029,188,211,402,712,s.s,184,s.s,1875
CC Coeur Haute Lande,88,426,237,751,96,555,268,919,94,156,357,738,s.s,217,s.s,1670
CC Coeur d'Astarac en Gascogne,35,147,75,257,42,150,111,303,49,63,122,245,47,34,",",560
"CC Coeur d'Ostrevent [c,C,C,O,]",782,2463,851,4096,597,2339,850,3786,360,627,1812,3732,529,794,28,7882
CC Coeur d'Yvelines,127,587,355,1069,119,717,378,1214,617,419,548,520,76,93,10,2283
CC Coeur de Beauce,149,449,184,782,132,612,224,968,97,145,348,819,s.s,154,s.s,1750
CC Coeur de Berry,111,323,150,584,110,400,235,745,68,124,308,602,s.s,142,s.s,1329
CC Coeur de Brenne,20,67,61,148,16,86,59,161,19,28,57,142,34,29,",",309
CC Coeur de Charente,105,475,230,810,130,542,262,934,114,153,342,868,s.s,136,s.s,1744
CC Coeur de Chartreuse,65,293,138,496,70,375,132,577,166,149,237,413,s.s,64,s.s,1073
CC Coeur de France,114,435,286,835,122,423,264,809,74,105,269,840,s.s,229,s.s,1644
CC Coeur de Garonne,188,753,376,1317,172,1039,422,1633,266,397,688,1220,s.s,206,s.s,2950
CC Coeur de Lozère,85,306,79,470,67,284,111,462,107,113,228,344,s.s,98,s.s,932
CC Coeur de Maurienne Arvan,81,314,127,522,61,332,155,548,105,122,230,453,s.s,100,s.s,1070
CC Coeur de Nacre,136,524,210,870,119,542,295,956,262,244,422,697,s.s,111,s.s,1826
CC Coeur de Savoie,188,635,288,1111,202,866,369,1437,331,275,538,1036,128,226,14,2548
CC Coeur de Sologne,59,216,119,394,56,215,124,395,40,72,158,396,s.s,56,s.s,789
CC Coeur de Tarentaise,47,238,84,369,42,204,83,329,53,72,158,264,s.s,107,s.s,698
CC Coeur de l'Avesnois,301,850,403,1554,277,900,346,1523,128,222,679,1454,s.s,347,s.s,3077
CC Coeur du Perche,77,209,106,392,64,247,122,433,71,66,174,380,s.s,63,s.s,825
CC Coeur du Var,274,1021,484,1779,293,1262,611,2166,272,424,892,1738,s.s,341,s.s,3945
CC Coeur et Coteaux du Comminges,255,909,503,1667,263,1062,564,1889,273,346,774,1585,s.s,342,s.s,3556
CC Combrailles Sioule et Morge,105,346,124,575,90,482,198,770,117,139,325,615,s.s,69,s.s,1345
CC Commentry Montmarault Néris Communauté,155,535,298,988,128,620,383,1131,128,177,389,1058,s.s,196,s.s,2119
CC Communauté Bray-Eawy,165,397,197,759,191,559,232,982,84,146,377,840,s.s,153,s.s,1741
CC Communauté Lesneven Côte des Légendes,127,523,252,902,179,709,375,1263,218,282,581,908,s.s,72,s.s,2165
CC Communauté de Communes de Thann-Cernay,214,849,399,1462,235,912,414,1561,207,282,638,1450,s.s,280,s.s,3023
CC Comtal Lot et Truyère,68,244,114,426,61,303,189,553,125,128,228,372,s.s,61,s.s,979
CC Conflent-Canigó,150,705,332,1187,136,691,339,1166,237,215,542,1018,s.s,165,s.s,2353
CC Conques-Marcillac,34,160,79,273,51,215,111,377,96,99,151,241,s.s,26,s.s,650
CC Corbières Salanque Méditerranée,176,599,266,1041,162,711,302,1175,168,212,533,960,s.s,185,s.s,2216
CC Coteaux et Plaines du Pays Lafrançaisain,70,242,99,411,70,340,139,549,62,96,208,421,s.s,110,s.s,960
CC Coteaux et Vallées des Luys,38,135,64,237,36,174,105,315,33,66,142,244,s.s,41,s.s,552
CC Couesnon Marches de Bretagne,94,394,160,648,114,435,191,740,118,112,313,650,s.s,114,s.s,1388
CC Couserans-Pyrénées,166,968,459,1593,154,967,494,1615,411,358,779,1280,s.s,208,s.s,3208
CC Coutances Mer et Bocage,250,958,406,1614,268,1043,489,1800,255,353,719,1626,171,279,11,3414
CC Creuse Grand Sud,66,313,147,526,65,329,194,588,134,107,251,483,s.s,87,s.s,1114
CC Cère et Goul en Carladès,s.s,67,s.s,117,s.s,99,s.s,158,14,28,69,128,20,16,s.s,275
CC Côte Landes Nature,63,290,164,517,70,383,191,644,108,158,276,509,53,57,",",1161
CC Côte Ouest Centre Manche,144,389,179,712,169,521,266,956,77,116,344,842,106,170,13,1668
CC Côte d'Albâtre,207,560,229,996,199,754,349,1302,121,215,479,1047,s.s,245,s.s,2298
CC Côte d'Emeraude,160,673,346,1179,186,735,428,1349,400,379,610,922,90,113,14,2528
CC Côtes de Champagne et Val de Saulx,72,243,110,425,70,290,131,491,33,79,165,466,70,103,",",916
CC Côtes de Meuse Woëvre,34,136,63,233,28,148,63,239,34,63,109,215,26,25,",",472
CC Decazeville Communauté,117,351,191,659,97,407,217,721,76,133,285,674,s.s,113,s.s,1380
CC Dieulefit-Bourdeaux,38,226,115,379,43,292,132,467,149,126,193,292,s.s,40,s.s,846
CC Dombes Saône Vallée,137,545,200,882,167,671,294,1132,304,304,466,713,s.s,140,s.s,2014
CC Domfront Tinchebray Interco,95,271,120,486,84,332,140,556,53,84,226,501,s.s,109,s.s,1042
CC Douarnenez Communauté,118,522,253,893,129,563,301,993,293,232,463,736,s.s,77,s.s,1886
CC Dronne et Belle,48,189,102,339,50,228,127,405,58,86,170,318,s.s,65,s.s,744
CC Drôme Sud Provence,342,1150,412,1904,326,1552,655,2533,335,518,1029,1820,s.s,444,s.s,4437
CC Dômes Sancy Artense,35,196,84,315,40,254,128,422,89,97,187,303,s.s,29,s.s,737
CC Ecueillé-Valençay,57,210,139,406,49,202,135,386,48,51,143,400,s.s,76,s.s,792
CC Eguzon - Argenton - Vallée de la Creuse,119,438,216,773,118,462,263,843,92,118,330,799,s.s,162,s.s,1616
CC Elan Limousin Avenir Nature,139,495,233,867,138,606,272,1016,152,233,415,866,s.s,111,s.s,1883
CC Enclave des Papes-Pays de Grignan,161,605,351,1117,157,691,368,1216,169,257,514,986,s.s,250,s.s,2333
CC Entr'allier Besbre et Loire,134,452,272,858,137,588,358,1083,87,142,374,941,s.s,216,s.s,1941
CC Entre Aire et Meuse - Triaucourt-Vaubécourt,30,105,51,186,23,103,56,182,23,49,90,154,s.s,36,s.s,368
"CC Entre Arroux, Loire et Somme",120,370,202,692,99,442,337,878,78,127,315,755,s.s,176,s.s,1570
CC Entre Beauce et Perche,120,363,161,644,108,449,203,760,76,140,282,689,s.s,118,s.s,1404
CC Entre Dore et Allier,99,412,184,695,102,502,249,853,131,168,337,627,s.s,157,s.s,1548
CC Entre Juine et Renarde (Ccejr),97,366,191,654,80,387,203,670,201,237,292,411,s.s,118,s.s,1324
CC Entre Saône et Grosne,52,194,90,336,69,246,123,438,66,73,187,337,s.s,63,s.s,774
CC Estuaire et Sillon,196,591,235,1022,211,994,361,1566,308,409,627,1021,116,96,11,2588
CC Eure-Madrie-Seine,211,741,246,1198,207,872,341,1420,166,283,606,1116,s.s,244,s.s,2618
CC Falaises du Talou,175,510,207,892,144,661,301,1106,82,166,478,940,s.s,200,s.s,1998
CC Faucigny-Glières,137,588,222,947,107,673,281,1061,178,241,427,760,s.s,272,s.s,2008
CC Fercher Pays Florentais,79,233,113,425,63,292,140,495,61,82,184,467,44,82,",",920
CC Fier et Usses,48,267,93,408,63,338,130,531,158,138,220,336,s.s,38,s.s,939
CC Flandre Lys,291,754,299,1344,247,962,367,1576,192,332,685,1265,s.s,265,s.s,2920
"CC Forêts, Lacs, Terres en Champagne",41,127,47,215,34,173,70,277,40,51,90,237,s.s,34,s.s,492
"CC Forêts, Seine et Suzon",16,94,32,142,27,103,60,190,57,51,79,127,s.s,11,s.s,332
CC Fumel Vallée du Lot,108,584,291,983,114,608,391,1113,115,173,427,983,s.s,223,s.s,2096
CC Gally Mauldre,39,245,183,467,42,298,166,506,358,181,163,210,s.s,27,s.s,973
CC Gartempe - Saint Pardoux,21,102,55,178,19,107,59,185,32,31,93,167,15,25,",",363
CC Giennoises,217,728,263,1208,192,813,342,1347,152,213,515,1073,s.s,392,s.s,2555
CC Gorges Causses Cévennes,25,156,85,266,32,209,75,316,103,71,125,198,s.s,61,s.s,582
CC Grand Orb Communauté de Communes en Languedoc,150,539,274,963,136,547,297,980,152,172,420,929,s.s,126,s.s,1943
CC Grand Sud Tarn et Garonne,257,1065,398,1720,270,1467,502,2239,292,495,904,1607,246,404,11,3959
CC Grand-Figeac,182,762,328,1272,198,853,479,1530,354,347,622,1145,s.s,171,s.s,2802
CC Gâtinais Val de Loing,116,366,179,661,88,463,195,746,108,160,310,562,s.s,144,s.s,1407
CC Haut - Bugey,365,1684,559,2608,393,1711,637,2741,313,429,1097,1988,482,1014,26,5349
CC Haut Chemin-Pays de Pange,79,247,124,450,51,309,189,549,142,146,256,351,s.s,57,s.s,999
CC Haut Limousin en Marche,95,392,235,722,113,400,285,798,119,134,276,740,s.s,152,s.s,1520
CC Haut Nivernais-Val d'Yonne,71,225,116,412,82,209,115,406,45,64,164,373,s.s,96,s.s,818
CC Haut Val de Sèvre,171,593,240,1004,148,729,314,1191,181,234,478,1027,s.s,167,s.s,2195
CC Haut-Jura Saint-Claude,144,482,216,842,109,457,226,792,110,155,366,667,s.s,228,s.s,1634
CC Haut-Léon Communauté,172,658,330,1160,166,796,417,1379,263,288,604,1077,s.s,148,s.s,2539
CC Haute Maurienne Vanoise,31,152,48,231,28,163,77,268,48,59,115,183,s.s,63,s.s,499
CC Haute Sarthe Alpes Mancelles,160,424,206,790,128,504,239,871,59,139,332,856,s.s,169,s.s,1661
CC Haute Saulx et Perthois-Val d'Ornois,97,302,158,557,87,329,216,632,60,97,267,570,s.s,124,s.s,1189
CC Haute Vallée du Thoré,29,90,79,198,38,124,75,237,32,44,96,195,s.s,43,s.s,435
CC Haute-Corrèze Communauté,147,569,253,969,177,586,343,1106,169,202,485,933,109,166,11,2075
CC Haute-Provence-Pays de Banon,49,270,113,432,58,327,177,562,154,129,250,371,s.s,39,s.s,994
CC Hautes Terres,44,154,90,288,30,185,125,340,58,78,116,301,s.s,32,s.s,628
CC Houve-Pays Boulageois,136,387,178,701,107,529,252,888,91,168,375,722,s.s,132,s.s,1589
CC Inter-Caux-Vexin,289,777,365,1431,222,916,450,1588,338,362,731,1239,156,182,11,3019
CC Interco Normandie Sud Eure,290,1073,478,1841,320,1213,587,2120,231,365,797,1811,354,391,12,3961
CC Intercom Bernay Terres de Normandie,388,1228,522,2138,379,1423,676,2478,219,358,939,2234,s.s,498,s.s,4616
CC Intercom de la Vire Au Noireau,278,963,415,1656,280,1177,560,2017,193,252,698,1762,238,518,12,3673
CC Interrégionale Aumale - Blangy-Sur-Bresle,163,463,180,806,173,578,249,1000,53,109,354,872,s.s,245,s.s,1806
CC Isigny-Omaha Intercom,157,458,209,824,163,638,269,1070,111,147,394,886,s.s,227,s.s,1894
CC Isle Double Landais,93,292,141,526,77,308,176,561,49,68,190,575,s.s,113,s.s,1087
CC Isle Vern Salembre en Périgord,117,419,197,733,104,489,266,859,108,167,350,718,s.s,158,s.s,1592
CC Isle et Crempse en Périgord,58,311,154,523,62,343,191,596,79,119,239,514,s.s,101,s.s,1119
CC Jabron-Lure-Vançon-Durance,26,115,57,198,29,142,83,254,42,56,117,201,14,22,",",452
CC Jalle-Eau-Bourde,141,550,171,862,121,725,259,1105,399,327,480,643,s.s,59,s.s,1967
CC Jura Nord,67,191,105,363,40,255,102,397,55,94,163,358,s.s,51,s.s,760
CC Jura Sud,55,150,59,264,39,165,86,290,43,63,120,220,s.s,75,s.s,554
CC Lacs et Gorges du Verdon,45,213,125,383,43,238,169,450,64,81,189,372,s.s,67,s.s,833
CC Lamballe Terre et Mer,370,1237,573,2180,385,1605,722,2712,487,604,1173,2084,227,299,18,4892
CC Larzac et Vallées,25,112,44,181,17,131,73,221,39,51,93,170,s.s,23,s.s,402
CC Latitude Nord Gironde,169,493,213,875,138,790,279,1207,92,180,397,1066,s.s,183,s.s,2082
CC Lauragais Revel Sorezois,126,501,251,878,134,641,313,1088,195,239,501,785,114,122,10,1966
CC Lavalette Tude Dronne,79,334,148,561,91,363,231,685,94,132,271,567,s.s,96,s.s,1246
CC Leff Armor Communauté,167,705,283,1155,191,874,345,1410,239,317,622,1169,s.s,97,s.s,2565
CC Lieuvin Pays d'Auge,121,362,172,655,99,489,224,812,67,134,295,705,s.s,155,s.s,1467
CC Liffré-Cormier Communauté,100,401,132,633,142,563,187,892,234,220,364,580,49,66,12,1525
CC Loches Sud Touraine,315,1017,537,1869,261,1138,649,2048,317,356,834,1810,222,353,25,3917
CC Lodévois et Larzac,112,487,251,850,94,521,234,849,181,197,418,663,s.s,139,s.s,1699
CC Loir-Lucé-Bercé,164,482,254,900,164,624,345,1133,122,175,396,967,s.s,219,s.s,2033
CC Loire Layon Aubance,305,1018,393,1716,301,1210,547,2058,508,533,892,1425,199,197,20,3774
CC Loire et Allier,23,75,43,141,27,122,52,201,28,37,86,163,s.s,17,s.s,342
CC Loire et Semène,114,304,170,588,94,460,244,798,115,143,342,639,s.s,79,s.s,1386
"CC Loire, Nièvre et Bertranges",115,391,177,683,98,370,208,676,72,113,316,647,s.s,123,s.s,1359
"CC Loire, Vignobles et Nohain",162,483,229,874,149,574,336,1059,107,148,427,943,s.s,182,s.s,1933
CC Lot et Tolzac,38,159,76,273,43,189,96,328,57,55,125,256,s.s,80,s.s,601
CC Loudéac Communauté - Bretagne Centre,316,1090,414,1820,344,1222,482,2048,230,385,890,1749,282,322,10,3868
CC Loue-Lison,86,385,180,651,95,469,199,763,163,167,283,653,s.s,81,s.s,1414
CC Loué - Brûlon - Noyen,121,326,131,578,130,477,183,790,80,126,310,664,s.s,118,s.s,1368
CC Lyon Saint Exupéry en Dauphiné,172,636,220,1028,162,776,256,1194,143,240,487,908,s.s,270,s.s,2222
CC Lyons Andelle,145,446,196,787,134,581,263,978,76,134,383,789,s.s,214,s.s,1765
CC Lèze Ariège,203,683,307,1193,193,937,391,1521,323,381,631,1033,s.s,176,s.s,2714
CC Mad et Moselle,92,324,165,581,97,397,202,696,130,157,314,553,s.s,72,s.s,1277
CC Maine Coeur de Sarthe,108,324,132,564,121,426,188,735,96,153,323,557,s.s,96,s.s,1299
CC Maine Saosnois,191,585,246,1022,217,704,331,1252,81,149,487,1118,s.s,264,s.s,2274
CC Maison de l'Intercommunalité de Haute Tarentaise,61,413,98,572,53,417,137,607,145,164,318,358,59,125,10,1179
CC Marche Occitane - Val d'Anglin,29,106,73,208,33,100,70,203,25,37,79,208,s.s,27,s.s,411
CC Marches du Velay-Rochebaron,205,558,259,1022,158,703,344,1205,179,222,495,1007,s.s,176,s.s,2227
CC Maremne Adour Côte Sud,404,2057,686,3147,389,2566,1038,3993,1003,1167,1817,2604,242,295,12,7140
CC Maurienne Galibier,35,97,27,159,19,122,60,201,37,55,89,150,14,15,",",360
CC Mayenne Communauté,185,641,183,1009,240,745,247,1232,158,216,560,981,142,169,15,2241
"CC Meurthe, Mortagne, Moselle",107,323,116,546,110,358,170,638,92,116,264,563,74,75,",",1184
CC Meuse Rognon,39,190,84,313,49,219,102,370,27,53,149,324,50,80,",",683
CC Midi Corrézien,52,233,127,412,56,304,157,517,96,147,234,362,44,46,",",929
CC Minervois Saint-Ponais Orb-Jaur,77,377,202,656,74,439,221,734,160,157,369,559,s.s,77,s.s,1390
CC Mirebellois et Fontenois,45,199,78,322,42,243,91,376,78,86,164,291,s.s,45,s.s,698
CC Mond'arverne Communauté,164,741,283,1188,144,849,368,1361,401,388,562,970,93,124,11,2549
CC Mont Lozère,16,101,43,160,12,114,44,170,48,59,69,116,s.s,22,s.s,330
CC Montfort Communauté,148,416,153,717,117,535,195,847,254,231,376,557,s.s,69,s.s,1564
CC Monts d'Arrée Communauté,31,181,111,323,43,184,110,337,77,78,190,249,s.s,29,s.s,660
"CC Monts, Rance et Rougier",19,120,60,199,20,119,68,207,51,49,94,167,19,26,",",406
CC Moret Seine et Loing,187,683,330,1200,158,728,360,1246,376,376,552,845,s.s,169,s.s,2446
CC Morvan Sommets et Grands Lacs,33,198,132,363,43,174,116,333,57,73,162,293,s.s,55,s.s,696
CC Moselle et Madon,161,536,250,947,138,502,215,855,201,200,391,783,s.s,122,s.s,1802
CC Moutierrois Talmondais,189,743,403,1335,208,920,563,1691,193,356,726,1396,s.s,190,s.s,3026
CC Mâconnais - Tournugeois,97,377,147,621,103,383,202,688,98,135,272,560,s.s,153,s.s,1309
CC Méditerranée Porte des Maures,323,1184,554,2061,283,1237,696,2216,371,506,1085,1700,301,304,10,4277
CC Médoc Atlantique,194,831,386,1411,159,1014,508,1681,284,355,725,1291,s.s,228,s.s,3092
CC Médoc Coeur de Presqu'ile,245,881,366,1492,264,1088,481,1833,175,247,685,1394,s.s,545,s.s,3325
CC Médoc Estuaire,151,517,177,845,158,766,308,1232,172,280,460,887,97,170,11,2077
CC Médullienne,135,469,146,750,114,657,243,1014,152,240,368,777,s.s,132,s.s,1764
CC Mézenc-Loire-Meygal,46,177,102,325,42,201,110,353,59,88,161,298,s.s,37,s.s,678
CC Nebbiu - Conca d'Oro,27,163,84,274,35,212,104,351,66,53,182,211,s.s,60,s.s,625
CC Neste Barousse,24,117,72,213,25,149,97,271,45,49,114,218,s.s,32,s.s,484
CC Nièvre et Somme,253,860,361,1474,224,812,345,1381,112,175,605,1383,s.s,296,s.s,2855
CC Norge et Tille,60,153,80,293,27,238,134,399,119,127,157,241,s.s,25,s.s,692
CC Normandie-Cabourg-Pays d'Auge,202,631,305,1138,187,691,362,1240,220,255,474,1082,s.s,202,s.s,2378
CC Océan Marais de Monts,131,500,232,863,128,568,347,1043,148,203,449,872,s.s,126,s.s,1906
CC Orée de Bercé - Belinois,118,346,157,621,136,464,198,798,92,141,331,684,s.s,103,s.s,1419
CC Osartis Marquion,275,837,362,1474,258,1075,444,1777,221,391,838,1394,168,217,22,3251
CC Ouche et Montagne,39,165,80,284,28,206,111,345,95,112,149,222,22,29,",",629
CC Ouest Limousin,53,183,110,346,45,221,155,421,49,80,173,340,s.s,71,s.s,767
CC Pays Créçois,128,507,260,895,127,660,267,1054,304,295,508,611,105,111,15,1949
"CC Pays Dunois, Pays Sostranien, Bénévent/Grand-Bourg",117,416,241,774,93,422,265,780,117,131,320,780,s.s,127,s.s,1554
CC Pays Forcalquier et Montagne de Lure,58,316,130,504,58,329,171,558,162,111,237,419,s.s,79,s.s,1062
CC Pays Fort Sancerrois Val de Loire,89,302,180,571,98,406,200,704,82,106,308,590,s.s,99,s.s,1275
CC Pays Rhin - Brisach,157,532,246,935,138,612,330,1080,145,216,446,917,130,161,",",2015
CC Pays Ségali,62,224,111,397,55,318,148,521,106,137,207,381,s.s,46,s.s,918
CC Pays Vaison Ventoux (Copavo),82,384,211,677,89,504,295,888,144,191,348,629,s.s,142,s.s,1565
CC Pays d'Apt-Luberon,195,855,404,1454,195,935,459,1589,331,324,719,1148,190,318,13,3043
CC Pays d'Evian Vallée d'Abondance,184,915,368,1467,152,1039,408,1599,428,409,662,1224,136,197,10,3066
CC Pays d'Opale,247,604,254,1105,220,732,286,1238,141,245,546,1064,s.s,223,s.s,2343
CC Pays d'Orthe et Arrigans,138,541,287,966,119,728,320,1167,180,246,501,952,128,126,",",2133
CC Pays d'Uzès,164,728,306,1198,151,808,402,1361,298,344,587,975,s.s,187,s.s,2559
"CC Pays de Boussac, Carrefour des Quatre Provinces, Evaux-Les-Bains/Chambon-Sur-Voueize",95,310,209,614,79,333,227,639,80,114,289,605,s.s,95,s.s,1253
CC Pays de Chantonnay,153,370,164,687,177,593,272,1042,107,167,373,817,s.s,160,s.s,1729
CC Pays de Coulommiers,254,864,386,1504,225,1043,413,1681,268,336,806,1274,218,271,12,3185
CC Pays de Fontenay-Vendée,229,876,378,1483,253,998,486,1737,204,294,685,1564,s.s,270,s.s,3220
CC Pays de L?audunois et du Bassin de Landres,116,461,195,772,105,551,287,943,89,144,377,894,s.s,122,s.s,1715
CC Pays de Montereau,267,1121,422,1810,279,1245,429,1953,299,348,827,1478,272,528,11,3763
CC Pays de Nay,131,433,208,772,111,626,313,1050,229,245,431,753,s.s,92,s.s,1822
CC Pays de Nemours,162,659,278,1099,174,758,321,1253,191,253,497,884,s.s,324,s.s,2352
CC Pays de Nexon Monts de Chalus,46,207,105,358,48,267,125,440,79,76,183,353,s.s,52,s.s,798
CC Pays de Nérondes,19,101,55,175,29,125,58,212,13,24,77,205,s.s,36,s.s,387
CC Pays des Vans en Cévennes,51,313,186,550,50,329,158,537,133,136,282,414,s.s,59,s.s,1087
CC Pays du Mont-Blanc,197,891,290,1378,203,913,393,1509,384,394,663,1040,173,211,22,2887
CC Perthois-Bocage et Der,23,92,41,156,25,140,69,234,16,47,83,176,s.s,41,s.s,390
CC Petite Montagne,27,109,52,188,31,116,58,205,34,30,81,168,38,42,",",393
CC Picardie des Châteaux,172,438,216,826,129,496,201,826,79,135,364,771,s.s,151,s.s,1652
CC Piège Lauragais Malepère,93,347,164,604,90,470,220,780,130,170,336,583,s.s,84,s.s,1384
CC Plaine Limagne,113,475,200,788,104,554,246,904,124,162,352,755,117,182,",",1692
CC Plaines et Monts de France,116,335,136,587,104,402,163,669,118,175,309,495,s.s,75,s.s,1256
CC Plateau de Caux-Doudeville-Yerville,132,368,146,646,143,535,220,898,86,140,366,713,101,138,",",1544
CC Pleyben-Châteaulin-Porzay,126,468,199,793,134,595,284,1013,193,241,454,741,s.s,74,s.s,1806
CC Poher Communauté,114,324,145,583,105,360,187,652,92,127,300,548,s.s,83,s.s,1235
CC Ponthieu-Marquenterre,235,740,272,1247,254,849,354,1457,133,236,571,1238,s.s,282,s.s,2704
CC Pontivy Communauté,313,1013,388,1714,306,1063,502,1871,295,421,907,1459,194,288,21,3585
CC Porte Océane du Limousin,146,510,243,899,163,601,296,1060,127,160,414,936,s.s,202,s.s,1959
CC Porte d'Alsace - Largue,114,334,252,700,102,369,231,702,89,130,282,669,s.s,132,s.s,1402
CC Porte d'Aquitaine en Pays de Serres,31,101,44,176,28,131,58,217,34,40,92,181,20,26,",",393
CC Porte de Dromardèche,377,1152,492,2021,347,1506,608,2461,294,454,953,1887,326,555,13,4482
CC Porte de Maurienne,24,99,55,178,36,166,70,272,44,43,109,200,s.s,28,s.s,450
CC Porte du Jura,52,192,61,305,55,181,103,339,46,64,121,308,s.s,56,s.s,644
CC Portes de la Creuse en Marche,24,122,69,215,34,128,99,261,21,37,102,237,s.s,47,s.s,476
CC Portes du Berry Entre Loire et Val d'Aubois,52,184,101,337,38,233,132,403,32,53,168,351,s.s,75,s.s,740
CC Presqu'île de Crozon-Aulne Maritime,132,503,238,873,129,625,308,1062,242,249,475,806,s.s,76,s.s,1935
CC Provence Verdon,139,492,259,890,136,665,287,1088,178,217,453,880,122,115,13,1978
CC Pré-Bocage Intercom,133,414,190,737,151,585,225,961,128,154,365,780,s.s,179,s.s,1698
CC Pyrénées Audoises,73,348,201,622,73,340,273,686,134,119,289,570,s.s,119,s.s,1308
CC Pyrénées Cerdagne,47,202,82,331,60,204,92,356,76,76,181,256,s.s,49,s.s,687
CC Pyrénées Haut Garonnaises,91,353,174,618,73,325,231,629,104,127,294,580,s.s,62,s.s,1247
CC Pyrénées Vallées des Gaves,80,360,162,602,69,477,284,830,187,176,359,578,s.s,63,s.s,1432
CC Pévèle-Carembault,519,1645,680,2844,434,1874,817,3125,939,885,1418,2009,326,361,31,5969
CC Quercy - Bouriane,55,217,133,405,50,233,161,444,73,93,204,362,s.s,62,s.s,849
CC Quercy Vert-Aveyron,137,476,184,797,148,710,280,1138,165,209,439,825,s.s,183,s.s,1935
CC Questembert Communauté,83,497,199,779,121,679,292,1092,190,234,451,830,s.s,84,s.s,1871
CC Rahin et Cherimont,84,241,128,453,76,276,135,487,58,94,178,409,s.s,111,s.s,940
CC Randon - Margeride,22,55,21,98,16,76,31,123,23,47,58,65,s.s,20,s.s,221
CC Retz en Valois,236,750,310,1296,204,897,423,1524,176,245,593,1251,s.s,333,s.s,2820
"CC Rhony, Vistre, Vidourle",180,654,296,1130,187,796,364,1347,280,362,581,984,120,138,12,2477
CC Rhône Crussol,168,607,239,1014,162,817,385,1364,329,355,524,933,s.s,123,s.s,2378
CC Rhône Lez Provence,229,806,341,1376,213,875,423,1511,151,258,581,1240,201,446,10,2887
CC Riom Limagne et Volcans,364,1343,488,2195,335,1558,745,2638,581,578,1058,1937,267,400,12,4833
CC Rives de Moselle,266,1287,570,2123,306,1356,694,2356,414,493,971,1938,s.s,422,s.s,4479
"CC Rives de Saône, Cc Saint Jean de Losne Seurre",118,365,189,672,89,527,236,852,83,118,307,736,s.s,187,s.s,1524
CC Rives de l'Ain - Pays du Cerdon,76,300,124,500,84,359,158,601,81,118,264,496,s.s,81,s.s,1101
CC Roi Morvan Communauté,139,522,325,986,134,581,347,1062,178,197,480,931,s.s,144,s.s,2048
CC Roumois Seine,295,937,369,1601,277,1242,499,2018,238,427,893,1636,157,249,19,3619
CC Roussillon-Conflent,136,700,282,1118,152,710,282,1144,147,204,429,947,s.s,296,s.s,2262
CC Rurales de l'Entre-Deux-Mers,101,361,167,629,83,499,230,812,98,146,286,661,s.s,158,s.s,1441
"CC Région Lézignanaise, Corbières et Minervois",252,935,421,1608,216,970,492,1678,220,316,725,1506,222,279,18,3286
"CC Saint Affricain, Roquefort, Sept Vallons",76,297,121,494,63,307,165,535,101,141,224,406,s.s,79,s.s,1029
CC Saint Cyr Mère Boitier Entre Charolais et Mâconnais,25,140,60,225,27,139,64,230,51,61,112,185,s.s,27,s.s,455
CC Saint-Pourçain Sioule Limagne,171,692,325,1188,186,793,410,1389,182,216,547,1217,s.s,214,s.s,2577
CC Sarlat-Périgord Noir,119,426,240,785,102,531,293,926,160,178,372,710,s.s,174,s.s,1711
CC Sarrebourg Moselle Sud,268,858,423,1549,271,982,468,1721,192,316,689,1495,246,311,21,3270
CC Sauer-Pechelbronn,77,266,128,471,84,305,194,583,64,98,208,538,s.s,97,s.s,1054
CC Sauldre et Sologne,92,293,140,525,93,292,187,572,53,102,216,507,s.s,135,s.s,1097
CC Sausseron Impressionnistes,71,291,169,531,73,337,203,613,203,195,278,350,s.s,64,s.s,1144
CC Save Garonne et Côteaux de Cadours,165,681,244,1090,160,954,323,1437,319,362,654,930,s.s,145,s.s,2527
CC Saône Doubs Bresse,69,209,101,379,75,305,145,525,56,90,181,452,50,75,",",904
CC Saône-Beaujolais,240,752,331,1323,230,1047,449,1726,282,330,699,1284,s.s,278,s.s,3049
CC Seine et Aube,57,205,103,365,53,282,142,477,44,65,137,454,s.s,80,s.s,842
CC Senlis Sud Oise,92,461,230,783,106,541,239,886,333,250,360,485,s.s,115,s.s,1669
CC Serein et Armance,157,559,229,945,144,603,324,1071,89,148,367,1007,s.s,275,s.s,2016
CC Serre-Ponçon,108,536,219,863,96,553,232,881,225,270,457,636,s.s,65,s.s,1744
CC Serre-Ponçon Val d'Avance,37,211,81,329,46,194,91,331,68,75,143,293,s.s,31,s.s,660
CC Seulles Terre et Mer,78,280,89,447,75,312,147,534,92,124,232,402,s.s,85,s.s,981
CC Sidobre Val d'Agout-Vals et Plateaux des Monts de Lacaune,47,230,141,418,75,311,171,557,79,119,220,405,s.s,83,s.s,975
CC Somme Sud-Ouest,273,809,348,1430,230,935,392,1557,145,255,595,1346,s.s,320,s.s,2987
CC Sud Côte Chalonnaise,47,204,100,351,64,237,129,430,89,114,174,319,s.s,40,s.s,781
CC Sud Nivernais,117,389,200,706,112,413,229,754,48,125,268,819,s.s,118,s.s,1460
CC Sud Retz Atlantique,181,638,283,1102,203,826,364,1393,175,255,582,1174,119,176,14,2495
CC Sud Sarthe,208,608,327,1143,192,805,407,1404,105,205,474,1282,s.s,289,s.s,2547
CC Sud Vendée Littoral,352,1204,583,2139,342,1470,769,2581,249,437,972,2408,265,378,11,4720
CC Sud-Hérault,118,498,198,814,115,523,251,889,138,162,396,766,s.s,136,s.s,1703
CC Sud-Roussillon,177,781,370,1328,189,874,472,1535,239,290,657,1208,233,226,10,2863
CC Sumène - Artense,39,121,54,214,37,134,89,260,28,47,119,198,s.s,41,s.s,474
CC Sèvre et Loire,241,872,344,1457,273,1146,478,1897,379,510,826,1299,144,172,24,3354
CC Tannay-Brinon-Corbigny,36,136,84,256,37,140,108,285,33,42,110,274,37,45,",",541
CC Tarn-Agout,145,547,263,955,154,799,313,1266,278,301,553,860,s.s,120,s.s,2221
CC Terre Lorraine du Longuyonnais,69,270,157,496,68,299,147,514,65,78,208,489,s.s,99,s.s,1010
CC Terre d'Eau,114,444,209,767,137,491,249,877,99,147,329,777,s.s,169,s.s,1644
CC Terre de Camargue,214,798,365,1377,168,820,422,1410,242,291,628,1163,220,227,16,2787
CC Terre de Picardie,174,488,167,829,162,529,254,945,63,118,339,821,s.s,244,s.s,1774
CC Terres Touloises,256,979,372,1607,233,1036,431,1700,230,359,738,1436,205,326,13,3307
CC Terres de Bresse,116,363,183,662,121,563,293,977,104,157,344,767,s.s,152,s.s,1639
CC Terres de Chalosse,94,379,182,655,92,490,262,844,104,169,342,733,s.s,75,s.s,1499
"CC Terres de Montaigu, Cc Montaigu-Rocheservière",258,823,282,1363,270,1154,446,1870,351,419,793,1316,131,199,24,3233
CC Terres de Perche,100,349,150,599,99,393,186,678,51,78,258,612,s.s,128,s.s,1277
CC Terres de Saône,64,247,94,405,70,267,126,463,60,72,173,434,57,72,",",868
CC Terres des Confluences,335,1604,535,2474,397,1709,643,2749,266,379,997,1835,485,1236,25,5223
CC Terres du Haut Berry,130,443,190,763,107,533,251,891,135,165,376,745,s.s,138,s.s,1654
CC Territoriale Sud-Luberon,161,601,278,1040,133,687,314,1134,313,298,495,810,s.s,139,s.s,2174
CC Terroir de Caux,248,588,292,1128,254,899,448,1601,147,215,646,1236,s.s,294,s.s,2729
CC Thiers Dore et Montagne,284,1096,518,1898,262,1188,631,2081,237,324,796,1821,s.s,479,s.s,3979
CC Thiérache Sambre et Oise,172,614,220,1006,183,532,246,961,48,97,339,928,s.s,341,s.s,1967
CC Tille et Venelle,28,98,35,161,29,112,50,191,32,31,77,158,s.s,23,s.s,352
CC Touraine Ouest Val de Loire,218,721,317,1256,221,933,431,1585,188,285,586,1313,198,258,13,2841
CC Touraine Val de Vienne,142,537,275,954,121,604,360,1085,120,168,388,1026,s.s,182,s.s,2039
CC Touraine Vallée de l'Indre,266,810,395,1471,264,1142,541,1947,376,474,794,1391,s.s,200,s.s,3418
CC Touraine-Est Vallées,209,639,273,1121,160,828,334,1322,313,352,590,957,s.s,122,s.s,2443
CC Usses et Rhône,50,345,154,549,82,421,171,674,142,137,279,530,s.s,64,s.s,1223
CC Val 81,29,84,52,165,25,107,58,190,34,30,94,153,19,25,",",355
CC Val Briard,153,482,227,862,140,617,276,1033,229,288,464,702,s.s,97,s.s,1895
CC Val Eyrieux,61,190,139,390,58,208,211,477,64,99,216,343,s.s,76,s.s,867
CC Val Guiers,48,242,108,398,53,297,149,499,97,94,206,402,s.s,48,s.s,897
CC Val Vanoise Tarentaise,32,146,49,227,29,180,73,282,85,78,127,164,s.s,33,s.s,509
CC Val de Charente,103,339,145,587,101,347,189,637,71,82,245,578,s.s,147,s.s,1224
CC Val de Gers,38,157,74,269,40,180,88,308,60,78,144,233,24,38,",",577
CC Val de Gray,171,428,198,797,163,486,265,914,91,120,348,840,123,189,",",1711
CC Val de Gâtine,99,395,195,689,105,485,230,820,93,165,341,756,s.s,90,s.s,1509
CC Val de Ligne,46,229,105,380,38,186,121,345,78,81,187,275,s.s,61,s.s,725
CC Val de Meuse - Voie Sacrée,59,148,65,272,39,200,73,312,33,57,155,265,s.s,42,s.s,584
CC Val de Saône Centre,97,272,116,485,79,382,192,653,87,133,287,476,s.s,80,s.s,1138
CC Val de l'Indre - Brenne,91,246,152,489,83,293,159,535,48,80,196,528,s.s,97,s.s,1024
CC Val Ès Dunes,110,337,114,561,117,472,174,763,96,138,310,596,s.s,116,s.s,1324
CC Val'aïgo,93,396,151,640,89,497,184,770,160,183,311,547,s.s,120,s.s,1410
CC Val-De-Cher-Controis,307,1005,453,1765,280,1144,547,1971,226,343,699,1786,267,395,20,3736
CC Vallons de Haute-Bretagne Communauté,201,880,306,1387,233,1077,414,1724,362,435,760,1278,s.s,133,s.s,3111
CC Vallée de l'Ubaye - Serre-Ponçon,64,246,123,433,55,263,119,437,104,118,210,338,s.s,41,s.s,870
CC Vallée de l'hérault,256,1131,498,1885,236,1308,543,2087,557,542,970,1491,s.s,208,s.s,3972
CC Vallée de la Dordogne et Forêt Bessède,43,196,96,335,55,225,124,404,61,73,168,309,s.s,81,s.s,739
CC Vallée des Baux-Alpilles (Cc Vba),155,551,311,1017,158,745,404,1307,311,314,547,841,s.s,186,s.s,2324
CC Vallées de l'Orne et de l'Odon,126,391,145,662,98,489,193,780,180,188,348,556,55,104,11,1442
CC Vallées et Plateau d'Ardenne,203,563,296,1062,149,637,313,1099,98,161,415,1018,s.s,261,s.s,2161
CC Vals de Saintonge,336,1268,568,2172,336,1447,839,2622,274,430,956,2411,s.s,405,s.s,4794
"CC Vendée, Sèvre, Autise",93,327,144,564,97,437,191,725,79,123,314,601,s.s,105,s.s,1289
CC Ventoux Sud,75,234,104,413,59,281,137,477,67,95,207,368,s.s,93,s.s,890
CC Vexin Centre,114,378,195,687,92,460,213,765,208,240,375,480,s.s,72,s.s,1452
CC Vienne et Gartempe,199,642,332,1173,195,745,459,1399,155,221,559,1297,s.s,203,s.s,2572
CC Vierzon-Sologne-Berry,257,1142,532,1931,230,1036,460,1726,169,275,658,1768,s.s,549,s.s,3657
CC Vézère-Monédières-Millesources,11,67,43,121,16,68,53,137,34,20,69,101,s.s,10,s.s,258
CC Xaintrie Val'dordogne,51,184,103,338,41,207,137,385,61,87,144,322,s.s,51,s.s,723
CC Yonne Nord,154,442,201,797,120,573,256,949,117,173,382,839,s.s,134,s.s,1746
CC d'Aire Sur l'Adour,67,247,124,438,61,269,155,485,62,82,190,440,43,106,",",923
CC d'Altkirch et Environs,191,809,500,1500,189,844,472,1505,248,351,569,1387,s.s,288,s.s,3005
"CC d'Arcis, Mailly, Ramerupt",74,234,117,425,60,299,122,481,44,77,169,429,s.s,107,s.s,906
CC d'Auberive Vingeanne et Montsaugeonnais,43,134,65,242,41,180,106,327,37,52,120,260,s.s,44,s.s,569
CC d'Erdre et Gesvres,350,1029,363,1742,298,1430,492,2220,681,655,933,1418,134,125,16,3962
CC de Bayeux Intercom,198,703,283,1184,205,807,346,1358,259,272,509,1066,s.s,262,s.s,2542
CC de Belle Ile en Mer,32,159,68,259,38,194,99,331,78,78,170,202,s.s,30,s.s,590
CC de Bièvre Est,132,363,168,663,101,536,197,834,149,185,353,608,s.s,112,s.s,1497
CC de Blavet Bellevue Océan,91,306,123,520,93,452,244,789,137,174,347,541,s.s,59,s.s,1309
CC de Blaye,178,555,223,956,162,714,309,1185,128,142,457,1031,s.s,231,s.s,2141
CC de Bléré Val de Cher,123,400,175,698,127,495,240,862,134,183,356,691,65,119,12,1560
CC de Brocéliande,70,363,129,562,90,462,139,691,174,206,307,452,s.s,58,s.s,1253
CC de Calvi Balagne,93,382,183,658,116,657,218,991,176,160,439,527,161,175,11,1649
CC de Cambremer,24,95,49,168,28,111,62,201,36,50,69,146,27,41,",",369
CC de Cattenom et Environs,81,336,138,555,73,438,177,688,195,187,284,468,s.s,63,s.s,1243
CC de Charente Limousine,195,624,302,1121,167,784,416,1367,144,161,576,1208,s.s,231,s.s,2488
CC de Commercy - Void - Vaucouleurs,139,505,224,868,132,617,293,1042,93,157,392,957,s.s,188,s.s,1910
CC de Cèze Cévennes,143,632,327,1102,125,592,371,1088,127,183,499,987,s.s,203,s.s,2190
CC de Damvillers Spincourt,51,152,71,274,34,200,87,321,25,46,107,340,s.s,45,s.s,595
CC de Desvres-Samer,131,489,163,783,171,634,228,1033,100,203,470,767,s.s,155,s.s,1816
CC de Domme- Villefranche du Périgord,37,178,110,325,39,203,127,369,59,91,161,292,s.s,52,s.s,694
CC de Fium'orbu Castellu,64,276,141,481,73,363,176,612,103,89,251,384,s.s,163,s.s,1093
CC de Flandre Intérieure,617,1927,752,3296,596,2318,981,3895,624,791,1670,2961,427,703,15,7191
CC de Forez-Est,316,978,459,1753,382,1336,648,2366,347,455,973,1851,199,280,14,4119
CC de Freyming-Merlebach,292,1174,413,1879,216,998,469,1683,153,289,729,1682,s.s,444,s.s,3562
CC de Gevrey-Chambertin et de Nuits-Saint-Georges,121,491,210,822,114,554,261,929,197,219,355,764,s.s,125,s.s,1751
CC de Grand Lieu,241,695,232,1168,214,965,333,1512,299,368,674,1092,90,135,22,2680
"CC de Granville, Terre et Mer",278,905,444,1627,275,974,542,1791,310,371,776,1492,210,246,13,3418
CC de Gâtine et Choisilles - Pays de Racan,116,358,170,644,82,524,215,821,129,204,338,614,s.s,102,s.s,1465
CC de Gémozac et de la Saintonge Viticole,90,295,173,558,104,455,228,787,51,142,292,666,s.s,92,s.s,1345
CC de Hanau- la Petite Pierre,126,478,216,820,130,551,274,955,123,185,346,833,s.s,160,s.s,1775
CC de Haute Cornouaille,89,291,178,558,98,381,179,658,99,121,293,563,s.s,76,s.s,1216
CC de Lacq-Orthez,291,1023,502,1816,279,1333,686,2298,359,521,934,1890,s.s,236,s.s,4114
CC de Londinières,40,113,42,195,45,147,49,241,24,36,95,205,s.s,45,s.s,436
CC de Lévézou Pareloup,14,44,20,78,23,68,57,148,26,27,54,90,s.s,11,s.s,226
CC de Marana-Golo,124,454,178,756,124,671,249,1044,180,175,468,683,s.s,166,s.s,1800
CC de Marie-Galante,92,374,246,712,70,421,304,795,48,78,263,685,121,312,",",1507
CC de Millau Grands Causses,239,831,311,1381,177,864,393,1434,315,340,713,1088,s.s,204,s.s,2815
CC de Mimizan,104,355,122,581,82,457,221,760,101,140,340,588,s.s,101,s.s,1341
CC de Mirecourt Dompaire,92,403,159,654,92,421,193,706,78,104,295,642,s.s,150,s.s,1360
CC de Miribel et du Plateau,100,397,178,675,101,466,216,783,212,193,316,525,s.s,133,s.s,1458
CC de Montaigne Montravel et Gurson,70,280,120,470,72,341,184,597,58,101,177,512,s.s,132,s.s,1067
CC de Montbenoit,18,102,61,181,29,125,65,219,33,59,80,182,23,23,",",400
CC de Montesquieu,228,740,294,1262,168,999,391,1558,432,477,618,1040,124,119,10,2820
CC de Noblat,44,235,114,393,55,264,119,438,92,98,175,353,s.s,56,s.s,831
CC de Parthenay-Gâtine,224,738,332,1294,234,884,514,1632,207,301,624,1400,s.s,246,s.s,2926
CC de Petite Camargue,220,873,376,1469,187,1001,389,1577,215,306,639,1210,267,395,14,3046
CC de Ploërmel Communauté,246,829,330,1405,255,1005,493,1753,293,357,772,1365,159,202,10,3158
"CC de Podensac, des Coteaux de Garonne et de Lestiac-Sur-Garonne,paillet,rions",190,847,307,1344,170,980,384,1534,254,323,584,1271,s.s,295,s.s,2878
CC de Pont-Audemer / Val de Risle,219,695,292,1206,212,827,381,1420,133,225,514,1282,194,268,10,2626
CC de Portes Sud Périgord,35,142,76,253,40,214,108,362,45,75,157,266,32,40,",",615
CC de Pouilly en Auxois/Bligny Sur Ouche,42,129,77,248,42,174,108,324,50,68,103,268,s.s,48,s.s,572
CC de Puisaye-Forterre,162,627,325,1114,145,732,424,1301,168,209,480,1165,s.s,219,s.s,2415
CC de Sablé-Sur-Sarthe,243,790,265,1298,274,911,320,1505,142,206,570,1291,212,371,11,2803
CC de Saint-Méen Montauban,142,427,182,751,141,613,221,975,145,191,418,763,84,115,10,1726
CC de Saulieu,28,117,84,229,28,108,66,202,23,36,76,208,27,61,",",431
CC de Saverne-Marmoutier-Sommerau,205,766,319,1290,178,851,379,1408,264,297,572,1131,s.s,271,s.s,2698
CC de Seille et Mauchère ? Grand Couronné,92,269,130,491,78,347,148,573,138,157,259,437,s.s,33,s.s,1064
CC de Suippe et Vesle,33,78,40,151,32,185,55,272,23,34,92,198,s.s,40,s.s,423
CC de Sélestat,235,926,365,1526,259,1027,432,1718,301,333,638,1329,253,375,15,3244
CC de Sézanne-Sud Ouest Marnais,129,429,201,759,114,502,285,901,84,123,331,817,s.s,188,s.s,1660
CC de Vendeuvre-Soulaines,55,177,101,333,41,203,109,353,26,51,99,334,s.s,110,s.s,686
CC de Ventadour - Egletons - Monédières,48,169,97,314,46,213,123,382,46,73,153,290,s.s,80,s.s,696
CC de Vezouze en Piémont,76,292,173,541,69,259,155,483,41,70,196,496,s.s,143,s.s,1024
CC de Vie et Boulogne,242,803,315,1360,261,1179,475,1915,242,373,796,1492,159,203,10,3275
CC de Villedieu Intercom,67,308,143,518,67,325,167,559,47,95,200,571,s.s,100,s.s,1077
"CC de Vitry, Champagne et Der",164,698,253,1115,155,680,369,1204,89,195,410,1159,s.s,282,s.s,2319
CC de Yenne,26,112,64,202,33,155,60,248,49,54,103,211,s.s,14,s.s,450
CC de l'Agglomération Migennoise,162,398,141,701,133,434,170,737,62,86,252,713,s.s,214,s.s,1438
CC de l'Aillantais,42,168,77,287,43,176,118,337,58,70,128,284,s.s,47,s.s,624
CC de l'Aire Cantilienne,160,753,363,1276,158,902,443,1503,631,443,611,784,120,172,18,2779
CC de l'Alsace Bossue,134,466,242,842,132,537,286,955,89,146,371,880,s.s,168,s.s,1797
CC de l'Alta Rocca,44,194,84,322,32,265,121,418,64,79,178,253,s.s,107,s.s,740
CC de l'Arc Mosellan,169,514,239,922,114,621,346,1081,187,242,444,891,s.s,129,s.s,2003
CC de l'Argonne Ardennaise,70,320,147,537,78,348,150,576,50,83,216,548,s.s,141,s.s,1113
CC de l'Argonne Champenoise,63,223,114,400,54,293,128,475,46,65,187,403,s.s,102,s.s,875
CC de l'Ernée,108,288,105,501,116,364,161,641,83,109,248,548,s.s,90,s.s,1142
CC de l'Est Guyanais,79,247,82,408,72,280,64,416,10,10,59,219,s.s,359,s.s,824
CC de l'Est Lyonnais (Ccel),168,562,239,969,157,742,348,1247,379,327,479,825,s.s,106,s.s,2216
CC de l'Est de la Somme,217,673,236,1126,181,676,338,1195,61,136,476,1168,186,284,10,2321
CC de l'Estuaire - Canton de Saint Ciers Sur Gironde,135,451,187,773,121,616,276,1013,56,103,368,937,s.s,196,s.s,1786
CC de l'Ile d'Oléron,177,685,259,1121,166,720,441,1327,218,303,609,1047,s.s,128,s.s,2448
CC de l'Ile de Noirmoutier,62,205,116,383,52,249,166,467,64,99,232,356,s.s,49,s.s,850
CC de l'Ile de Ré,132,438,186,756,123,559,286,968,261,251,430,617,s.s,76,s.s,1724
CC de l'Ile-Rousse - Balagne,79,270,122,471,81,386,143,610,123,97,268,374,s.s,112,s.s,1081
CC de l'Oisans,58,336,110,504,55,330,117,502,132,139,279,347,s.s,55,s.s,1006
CC de l'Oise Picarde,239,666,266,1171,227,714,250,1191,117,173,459,1204,s.s,198,s.s,2362
CC de l'Oriente,19,121,57,197,36,127,69,232,25,42,89,144,s.s,77,s.s,429
CC de l'Orvin et de l'Ardusson,41,175,72,288,45,254,121,420,30,48,135,345,76,74,",",708
CC de l'Ouest Corse,41,214,110,365,39,197,112,348,75,61,171,241,s.s,88,s.s,713
CC de l'Ouest Guyanais,406,1538,530,2474,513,2075,445,3033,103,123,786,1758,508,2197,32,5507
CC de l'Ouest Vosgien,146,552,279,977,143,514,278,935,81,165,395,892,s.s,226,s.s,1912
CC de l'Oust À Brocéliande Communauté,174,734,279,1187,189,944,404,1537,245,325,658,1181,156,144,15,2724
CC de l'Outre-Forêt,74,238,136,448,102,341,172,615,59,99,192,534,59,120,",",1063
CC de la Baie du Cotentin,165,457,215,837,155,533,263,951,88,146,343,885,s.s,211,s.s,1788
CC de la Basse-Zorn,64,218,124,406,72,254,149,475,74,102,195,410,s.s,54,s.s,881
CC de la Beauce Loirétaine,98,269,110,477,77,367,139,583,93,126,243,457,s.s,80,s.s,1060
CC de la Brie Champenoise,39,139,67,245,23,184,73,280,16,29,110,242,s.s,87,s.s,525
CC de la Castagniccia-Casinca,73,250,135,458,81,355,164,600,82,89,231,407,s.s,128,s.s,1058
CC de la Champagne Conlinoise et du Pays de Sillé,123,360,143,626,150,476,190,816,92,118,307,696,s.s,122,s.s,1442
CC de la Champagne Picarde,135,468,218,821,116,569,274,959,87,148,365,801,s.s,225,s.s,1780
CC de la Châtaigneraie Cantalienne,45,276,127,448,65,330,205,600,89,108,232,489,s.s,62,s.s,1048
CC de la Châtre et Sainte Sévère,99,322,173,594,67,326,197,590,70,95,260,555,s.s,97,s.s,1184
"CC de la Cléry, du Betz et de l'Ouanne",136,458,222,816,120,497,228,845,104,142,338,787,s.s,157,s.s,1661
CC de la Costa Verde,62,222,110,394,53,251,150,454,57,65,196,340,s.s,103,s.s,848
CC de la Côtière À Montluel,132,425,172,729,113,537,211,861,161,219,374,627,78,121,10,1590
CC de la Dombes,164,518,240,922,175,741,317,1233,226,278,469,915,110,146,11,2155
CC de la Forêt,112,270,104,486,82,347,136,565,80,146,234,444,s.s,81,s.s,1051
CC de la Gascogne Toulousaine,85,310,153,548,76,512,216,804,228,225,303,484,s.s,65,s.s,1352
CC de la Grande Vallée de la Marne,104,268,105,477,76,309,132,517,69,114,216,433,s.s,96,s.s,994
CC de la Haute Ariège,41,194,81,316,28,189,110,327,59,78,164,265,s.s,39,s.s,643
CC de la Haute Comté,93,393,173,659,109,419,236,764,75,115,266,653,s.s,205,s.s,1423
CC de la Haute Deûle,160,514,185,859,156,568,265,989,158,214,459,754,s.s,138,s.s,1848
CC de la Haute Saintonge,413,1502,678,2593,359,1982,1002,3343,293,475,1249,2965,387,554,13,5936
CC de la Haute Somme,214,833,341,1388,250,910,474,1634,102,210,633,1323,s.s,433,s.s,3022
CC de la Haute Vallée de Chevreuse,33,300,171,504,49,304,161,514,351,186,207,202,s.s,37,s.s,1018
CC de la Haute Vallée de l'Ognon,55,182,86,323,47,196,130,373,37,66,124,330,s.s,80,s.s,696
CC de la Haute Vallée de la Gravona,42,179,74,295,47,193,81,321,54,75,156,244,s.s,31,s.s,616
CC de la Haute-Bigorre,97,399,248,744,83,442,281,806,197,181,356,658,s.s,97,s.s,1550
CC de la Lomagne Gersoise,87,373,208,668,113,438,281,832,128,160,325,630,s.s,122,s.s,1500
CC de la Lomagne Tarn-Et-Garonnaise,57,226,88,371,50,245,109,404,67,70,144,338,s.s,84,s.s,775
CC de la Marche Berrichonne,14,71,48,133,17,86,65,168,21,24,73,144,s.s,18,s.s,301
CC de la Matheysine,99,378,180,657,80,414,188,682,144,153,309,574,s.s,83,s.s,1339
CC de la Moivre À la Coole,39,118,43,200,33,158,68,259,42,56,105,208,s.s,27,s.s,459
CC de la Montagne Noire,21,142,88,251,27,155,101,283,48,48,121,260,37,20,",",534
CC de la Montagne d'Ardèche,16,62,48,126,14,86,50,150,28,32,64,116,17,19,",",276
CC de la Mossig et du Vignoble,99,377,164,640,111,483,211,805,154,180,324,616,s.s,103,s.s,1445
CC de la Muse et des Raspes du Tarn,17,81,64,162,16,112,55,183,38,49,93,139,10,16,",",345
CC de la Picardie Verte,266,665,286,1217,251,804,314,1369,112,178,497,1277,s.s,250,s.s,2586
CC de la Pieve de l'Ornano,52,234,132,418,50,306,148,504,108,116,251,308,s.s,66,s.s,922
CC de la Plaine Dijonnaise,117,329,152,598,99,457,235,791,90,152,288,675,s.s,108,s.s,1389
CC de la Plaine Jurassienne,45,129,67,241,40,183,97,320,25,42,128,275,s.s,53,s.s,561
CC de la Plaine d'Estrées,98,296,137,531,93,410,170,673,98,162,268,502,s.s,86,s.s,1204
CC de la Plaine de l'Ain,451,1546,570,2567,454,2018,811,3283,484,671,1296,2506,341,522,30,5850
CC de la Plaine du Nord Loiret,56,107,55,218,31,152,75,258,31,50,119,196,s.s,48,s.s,476
CC de la Plaine du Rhin,55,181,176,412,55,253,194,502,79,70,180,429,s.s,101,s.s,914
CC de la Porte des Vosges Méridionales,184,731,359,1274,165,711,415,1291,172,255,523,1178,s.s,244,s.s,2565
CC de la Région d'Audruicq,209,544,209,962,183,768,299,1250,145,236,517,983,121,199,11,2212
CC de la Région d'Orgelet,26,86,36,148,15,99,37,151,33,35,62,134,17,18,",",299
CC de la Région d'Yvetot,185,552,224,961,190,680,283,1153,149,204,446,920,s.s,239,s.s,2114
CC de la Région de Bar Sur Aube,95,283,141,519,90,307,158,555,47,67,173,478,s.s,189,s.s,1074
CC de la Région de Blain,88,308,113,509,121,459,156,736,113,143,312,562,52,63,",",1245
CC de la Région de Condrieu,66,269,128,463,77,360,146,583,152,167,236,373,s.s,64,s.s,1046
CC de la Région de Guebwiller,222,858,372,1452,226,863,437,1526,237,294,591,1368,s.s,284,s.s,2978
CC de la Région de Levroux,24,147,59,230,36,131,68,235,22,39,81,246,s.s,39,s.s,465
CC de la Région de Molsheim-Mutzig,250,719,266,1235,228,860,318,1406,258,327,600,1129,s.s,203,s.s,2641
CC de la Région de Nozay,75,307,104,486,89,424,153,666,115,143,266,496,s.s,74,s.s,1152
CC de la Région de Rambervillers,97,280,166,543,103,302,186,591,43,89,221,524,s.s,133,s.s,1134
CC de la Save Au Touch,201,763,283,1247,202,1145,373,1720,513,462,720,966,112,182,12,2967
CC de la Sologne des Etangs,36,131,76,243,44,166,107,317,36,57,102,272,s.s,50,s.s,560
CC de la Sologne des Rivières,49,233,129,411,45,257,162,464,49,67,165,415,s.s,99,s.s,875
CC de la Station des Rousses-Haut Jura,30,170,92,292,38,179,76,293,83,82,138,223,s.s,29,s.s,585
CC de la Tenarèze,91,336,168,595,87,351,209,647,104,130,245,494,s.s,167,s.s,1242
CC de la Terre des Deux Caps,170,510,188,868,158,577,238,973,124,195,460,765,118,169,10,1841
CC de la Thiérache du Centre,232,728,297,1257,258,810,310,1378,81,212,537,1206,s.s,343,s.s,2635
CC de la Vallée Verte,22,160,60,242,23,150,75,248,64,68,108,197,s.s,30,s.s,490
CC de la Vallée d'Ossau,50,212,98,360,50,240,129,419,97,102,183,349,s.s,27,s.s,779
CC de la Vallée de Chamonix-Mont-Blanc,42,377,83,502,39,384,103,526,220,162,253,279,s.s,65,s.s,1028
CC de la Vallée de Kaysersberg,72,261,131,464,62,323,158,543,100,120,221,480,s.s,33,s.s,1007
CC de la Vallée de Munster,69,258,138,465,86,317,194,597,103,106,217,463,s.s,93,s.s,1062
CC de la Vallée de Saint-Amarin,72,218,129,419,71,232,152,455,57,68,170,461,s.s,70,s.s,874
CC de la Vallée de Villé,44,176,71,291,47,180,105,332,62,73,121,271,49,47,",",623
CC de la Vallée de l'Oise et des Trois Forêts,151,603,306,1060,128,730,334,1192,369,340,514,709,s.s,174,s.s,2252
CC de la Vallée de l'homme,70,332,185,587,72,443,244,759,144,166,319,534,s.s,100,s.s,1346
CC de la Vallée de la Bruche,142,434,212,788,129,464,241,834,95,139,312,827,s.s,150,s.s,1622
CC de la Vallée de la Doller et du Soultzbach,78,266,138,482,99,325,169,593,82,110,244,531,s.s,61,s.s,1075
CC de la Vallée de la Haute Sarthe,29,125,73,227,38,142,79,259,24,51,97,245,31,38,",",486
CC de la Vallée du Gapeau,187,556,263,1006,154,701,348,1203,237,261,559,863,s.s,148,s.s,2209
CC de la Vallée du Garon (Ccvg),123,457,213,793,97,588,225,910,374,272,365,501,s.s,109,s.s,1703
CC de la Vallée du Lot et du Vignoble,71,315,187,573,69,333,217,619,102,119,239,532,s.s,123,s.s,1192
CC de la Vanne et du Pays d'Othe,43,177,96,316,43,211,101,355,35,62,129,313,s.s,74,s.s,671
CC de la Veyle,110,362,157,629,118,445,194,757,95,153,321,631,s.s,102,s.s,1386
CC des 2 Vallées,70,234,127,431,49,273,150,472,117,122,208,339,s.s,61,s.s,903
CC des 4 Rivières,194,652,283,1129,196,736,335,1267,111,176,497,1161,s.s,243,s.s,2396
CC des 4b Sud Charente,105,387,191,683,104,517,303,924,99,167,335,734,s.s,168,s.s,1607
CC des 7 Vallées,214,671,265,1150,242,753,287,1282,133,219,618,1061,s.s,220,s.s,2432
CC des Albères et de la Côte Vermeille,499,2006,912,3417,436,2089,1018,3543,566,704,1656,2907,511,585,31,6960
CC des Aspres,157,747,276,1180,166,750,348,1264,201,240,580,993,s.s,239,s.s,2444
CC des Ballons des Hautes-Vosges,110,371,211,692,100,355,211,666,71,114,267,614,s.s,154,s.s,1358
CC des Baronnies en Drôme Provençale,128,627,305,1060,132,704,406,1242,295,258,516,922,s.s,172,s.s,2302
CC des Bastides Dordogne-Périgord,97,347,151,595,99,447,272,818,111,154,318,624,s.s,113,s.s,1413
CC des Bastides en Haut Agenais Périgord,76,298,155,529,88,399,218,705,77,127,273,559,s.s,118,s.s,1234
CC des Campagnes de l'Artois,165,522,248,935,184,739,298,1221,170,267,526,954,100,128,11,2156
CC des Causses À l'Aubrac,50,212,109,371,54,246,137,437,65,73,185,354,60,71,",",808
CC des Collines du Nord Dauphiné,96,295,165,556,124,480,242,846,148,200,350,553,67,68,16,1402
CC des Collines du Perche,31,100,52,183,40,132,72,244,32,35,96,182,28,54,",",427
CC des Collines du Perche Normand,99,222,99,420,64,279,132,475,50,59,169,449,s.s,86,s.s,895
CC des Combes,34,133,38,205,22,137,71,230,28,35,97,210,28,37,",",435
CC des Coteaux Arrats Gimone,27,176,84,287,35,255,121,411,95,84,163,277,43,36,",",698
CC des Coteaux Bellevue,97,288,138,523,67,387,189,643,219,232,265,372,s.s,39,s.s,1166
CC des Coteaux Bordelais,106,326,119,551,75,464,198,737,222,217,308,429,s.s,58,s.s,1288
CC des Coteaux de Pouyastruc et du Canton de Tournay,46,176,100,322,47,214,117,378,58,92,146,345,s.s,33,s.s,700
CC des Coteaux du Girou,92,312,180,584,81,449,233,763,251,232,353,410,52,49,",",1347
CC des Coteaux et Landes de Gascogne,74,274,137,485,67,324,170,561,74,88,208,503,s.s,110,s.s,1046
CC des Coëvrons,139,454,178,771,156,589,236,981,98,133,401,823,s.s,165,s.s,1752
CC des Crêtes Préardennaises,108,423,196,727,102,506,230,838,87,168,332,721,s.s,134,s.s,1565
CC des Cévennes Au Mont Lozère,20,104,51,175,12,126,63,201,67,51,88,129,21,20,",",376
CC des Cévennes Gangeoises et Suménoises,91,422,206,719,83,470,204,757,161,179,363,582,s.s,97,s.s,1476
CC des Deux Morin,169,480,216,865,173,662,260,1095,118,190,461,851,s.s,178,s.s,1960
CC des Deux Rives,147,488,166,801,132,585,247,964,103,144,369,723,s.s,283,s.s,1765
CC des Deux Vallées,188,552,220,960,156,626,237,1019,126,198,451,867,s.s,188,s.s,1979
CC des Deux Vallées Vertes,74,271,147,492,64,333,189,586,60,114,201,512,s.s,96,s.s,1078
CC des Forêts du Perche,46,178,80,304,41,183,115,339,28,50,133,299,71,62,",",643
CC des Gorges de l'Ardèche,161,607,278,1046,123,633,363,1119,180,292,512,944,s.s,110,s.s,2165
CC des Grands Lacs,183,749,325,1257,200,1124,534,1858,253,396,797,1269,s.s,237,s.s,3115
CC des Hautes Terres de l'Aubrac,21,55,24,100,17,61,30,108,13,28,61,87,10,s.s,s.s,208
CC des Hautes Vosges,251,753,391,1395,204,743,478,1425,188,297,643,1250,s.s,221,s.s,2820
CC des Hauts de Flandre,314,939,358,1611,295,1237,524,2056,302,390,932,1539,176,317,11,3667
CC des Hauts du Perche,60,168,93,321,46,171,88,305,29,59,101,324,s.s,65,s.s,626
CC des Hauts du Val de Saône,39,155,56,250,52,171,95,318,34,41,98,278,48,69,",",568
CC des Lacs de Champagne,58,218,85,361,50,254,96,400,40,52,129,347,s.s,98,s.s,761
CC des Lacs et Montagnes du Haut-Doubs,48,366,143,557,47,380,124,551,164,156,259,432,s.s,48,s.s,1108
CC des Landes d'Armagnac,49,217,114,380,43,259,161,463,54,81,194,395,s.s,72,s.s,843
CC des Lisières de l'Oise,93,337,149,579,79,416,193,688,113,132,258,567,s.s,108,s.s,1267
CC des Loges,221,782,274,1277,204,985,400,1589,272,414,604,1143,s.s,262,s.s,2866
CC des Luys en Béarn,121,425,221,767,122,684,273,1079,219,253,485,779,s.s,60,s.s,1846
"CC des Marchés du Périg Or Limousin, Thiviers-Jumilhac",62,268,141,471,66,306,165,537,85,87,218,441,s.s,104,s.s,1008
CC des Montagnes du Giffre,45,271,108,424,42,269,154,465,106,130,205,353,s.s,39,s.s,889
CC des Monts d'Alban et du Villefranchois,19,104,56,179,29,132,57,218,42,48,93,185,s.s,12,s.s,397
CC des Monts de Gy,28,103,35,166,32,162,64,258,34,53,88,180,s.s,42,s.s,424
CC des Monts de Lacaune et de la Montagne du Haut Languedoc,36,118,92,246,33,143,113,289,47,61,125,198,44,60,",",535
CC des Monts du Lyonnais,110,455,199,764,111,572,237,920,178,207,398,677,93,119,12,1684
CC des Monts du Pilat,81,240,114,435,73,290,114,477,142,121,236,342,s.s,38,s.s,912
CC des Pays d'Oise et d'halatte,226,803,338,1367,216,875,379,1470,265,343,619,1117,208,273,12,2837
"CC des Pays de Briey, du Jarnisy et de L?orne",356,1330,550,2236,294,1412,690,2396,276,394,1011,2328,229,384,10,4632
"CC des Pays de Caldaguès-Aubrac, Pierrefort-Neuvéglise, Planèze, Saint-Flour Margeride",79,300,169,548,85,426,211,722,97,147,289,605,s.s,59,s.s,1270
CC des Pays de Cayres et de Pradelles,13,69,58,140,23,96,51,170,20,40,64,153,s.s,15,s.s,310
CC des Pays de Rhône et Ouvèze,344,1546,604,2494,409,1710,668,2787,400,520,1152,2097,361,738,13,5281
CC des Pays de l'Aigle,163,561,252,976,174,673,300,1147,95,165,380,1064,s.s,262,s.s,2123
CC des Pays du Sel et du Vermois,153,642,228,1023,156,599,268,1023,148,216,458,956,s.s,152,s.s,2046
CC des Paysages de la Champagne,140,354,149,643,105,466,187,758,71,130,284,662,s.s,145,s.s,1401
CC des Portes Euréliennes D Ile de France,287,1054,462,1803,256,1338,583,2177,409,543,858,1589,265,300,16,3980
CC des Portes d'Ariège Pyrénées,299,1001,397,1697,247,1296,520,2063,309,355,868,1570,298,350,10,3760
CC des Portes de Romilly Sur Seine,164,668,309,1141,178,788,323,1289,131,131,451,1088,s.s,394,s.s,2430
CC des Portes de Rosheim,77,275,124,476,56,318,155,529,157,156,215,393,s.s,46,s.s,1005
CC des Portes de Sologne,82,236,103,421,72,315,144,531,130,124,224,363,s.s,57,s.s,952
CC des Portes de Vassivière,25,106,68,199,25,107,63,195,38,45,80,165,s.s,39,s.s,394
CC des Portes de l'Entre Deux Mers,85,457,185,727,90,551,222,863,313,265,379,513,s.s,68,s.s,1590
CC des Portes de la Thiérache,74,188,108,370,50,199,116,365,16,39,112,333,s.s,130,s.s,735
CC des Portes du Luxembourg,162,518,227,907,130,528,237,895,73,138,391,891,s.s,182,s.s,1802
CC des Quatre Rivières,122,501,234,857,126,599,253,978,202,210,394,795,s.s,137,s.s,1835
CC des Quatre Territoires,28,100,68,196,25,103,66,194,32,46,96,135,s.s,39,s.s,390
CC des Quatre Vallées,87,324,181,592,73,413,182,668,64,108,268,625,s.s,97,s.s,1260
CC des Rives du Haut Allier,93,333,198,624,74,363,227,664,127,130,314,555,s.s,86,s.s,1288
CC des Sablons,268,855,367,1490,260,988,416,1664,241,314,752,1223,242,369,13,3154
CC des Savanes,248,854,481,1583,291,1610,513,2414,146,175,524,1113,303,1726,10,3997
CC des Sorgues du Comtat,439,1455,594,2488,375,1703,724,2802,421,521,1159,2280,310,585,14,5290
CC des Sources de l'Orne,65,210,103,378,67,235,110,412,47,65,156,391,s.s,81,s.s,790
CC des Sources du Lac d'Annecy,67,314,119,500,72,350,166,588,163,132,245,434,s.s,74,s.s,1088
CC des Sucs,97,323,171,591,90,409,225,724,110,145,273,606,s.s,101,s.s,1315
CC des Terres d'Apcher-Margeride-Aubrac,35,126,62,223,39,142,83,264,45,65,125,189,s.s,28,s.s,487
CC des Terres d'Auxois,63,285,163,511,76,311,156,543,84,106,227,493,s.s,97,s.s,1054
CC des Terres du Lauragais,177,746,296,1219,140,1042,410,1592,530,463,669,924,s.s,115,s.s,2811
CC des Terres du Val de Loire,259,891,377,1527,236,1142,445,1823,311,409,732,1455,s.s,264,s.s,3350
CC des Trois Forêts,44,107,49,200,37,161,71,269,24,52,120,205,s.s,40,s.s,469
CC des Vallons du Lyonnais (Ccvl),107,424,158,689,115,568,208,891,349,273,344,500,s.s,54,s.s,1580
CC des Vallées d'Aigueblanche,23,125,47,195,27,173,94,294,48,58,120,192,s.s,44,s.s,489
CC des Vallées d'Auge et du Merlerault,85,320,160,565,80,327,167,574,43,92,183,594,s.s,128,s.s,1139
CC des Vallées de Thônes,89,349,95,533,63,400,154,617,189,205,277,393,s.s,42,s.s,1150
CC des Vallées de la Braye et de l'Anille,83,261,136,480,102,306,175,583,49,82,191,527,s.s,134,s.s,1063
CC des Vallées de la Tille et de l'Ignon,72,235,91,398,59,274,153,486,73,115,171,391,s.s,70,s.s,884
CC des Vallées du Clain,143,408,163,714,104,457,197,758,175,189,366,609,s.s,67,s.s,1472
CC des Vallées du Haut-Anjou,202,648,214,1064,233,995,334,1562,231,315,645,1103,s.s,178,s.s,2626
CC des Vals d'Aix et Isable,33,101,55,189,27,127,54,208,27,42,96,175,s.s,31,s.s,397
CC des Villes Soeurs,334,953,422,1709,319,1084,585,1988,148,283,771,1783,s.s,401,s.s,3697
CC des Vosges Côté Sud Ouest,72,222,124,418,63,242,149,454,51,61,151,433,s.s,102,s.s,872
CC des Vosges du Sud,72,260,128,460,62,304,162,528,96,113,209,417,s.s,75,s.s,988
CC du Barséquanais en Champagne,111,413,183,707,111,482,232,825,66,102,236,711,s.s,246,s.s,1532
CC du Bas Armagnac,40,139,92,271,51,176,114,341,28,60,150,261,58,55,",",612
CC du Bassin d'Arcachon Nord Atlantique (Coban Atlantique),388,1428,645,2461,375,1943,1024,3342,685,902,1479,2221,230,275,11,5803
CC du Bassin d'Aubenas,311,1282,540,2133,309,1384,614,2307,461,495,1042,1840,277,314,11,4440
CC du Bassin de Joinville en Champagne,96,354,143,593,72,330,176,578,42,70,244,578,s.s,146,s.s,1171
CC du Bassin de Marennes,105,404,169,678,99,417,260,776,59,139,291,734,s.s,146,s.s,1454
CC du Bassin de Mortagne Au Perche,73,282,112,467,83,267,162,512,61,82,183,462,s.s,91,s.s,979
CC du Bassin de Pompey,255,1036,374,1665,218,903,378,1499,278,296,744,1351,s.s,292,s.s,3164
CC du Bassin de Pont-À-Mousson,269,1106,328,1703,245,938,388,1571,238,349,765,1448,193,271,10,3274
CC du Bazadais,86,356,166,608,80,471,252,803,101,145,323,641,77,124,",",1411
CC du Bocage Bourbonnais,63,275,151,489,51,308,176,535,77,108,228,451,s.s,93,s.s,1024
CC du Bocage Mayennais,80,212,134,426,94,286,178,558,46,94,235,444,s.s,83,s.s,984
CC du Bonnevalais,79,198,99,376,82,286,124,492,51,78,192,398,s.s,73,s.s,868
CC du Briançonnais,113,776,199,1088,129,788,241,1158,345,360,624,741,s.s,92,s.s,2246
CC du Brivadois,106,374,173,653,91,483,222,796,120,126,314,665,s.s,129,s.s,1449
CC du Béarn des Gaves,68,265,162,495,90,386,227,703,125,136,253,559,s.s,59,s.s,1198
CC du Canton d'Erstein,223,814,385,1422,263,925,501,1689,254,354,606,1439,188,257,13,3111
CC du Canton d'Oulchy le Château,38,132,71,241,27,150,68,245,27,52,93,221,38,55,",",486
CC du Canton de Charly Sur Marne,101,390,139,630,84,439,171,694,76,126,273,610,s.s,128,s.s,1324
CC du Canton de Criquetot-l'esneval,110,202,112,424,93,320,182,595,97,108,292,395,s.s,76,s.s,1019
CC du Canton de Marcigny,22,89,63,174,24,112,63,199,18,42,74,166,25,48,",",373
CC du Canton de Pierre de Bresse,28,101,61,190,29,136,72,237,31,38,83,215,s.s,35,s.s,427
CC du Canton de Rumilly,162,589,169,920,162,638,262,1062,204,226,412,814,135,181,10,1982
CC du Canton de Semur en Brionnais,10,62,57,129,17,99,81,197,37,37,70,141,s.s,24,s.s,326
CC du Canton de Vatan et de Champagne Berrichonne,69,200,94,363,51,221,108,380,45,69,167,369,46,47,",",743
CC du Canton de la Chambre,37,120,40,197,33,156,86,275,41,59,119,209,16,28,",",472
CC du Cap Corse,34,128,87,249,29,177,80,286,71,55,141,195,s.s,39,s.s,535
CC du Castelrenaudais,123,371,158,652,116,451,219,786,87,146,297,670,s.s,138,s.s,1438
CC du Caudrésis et du Catésis,628,2420,846,3894,616,2334,924,3874,268,513,1622,3687,582,1080,16,7768
CC du Causse de Labastide Murat,18,61,42,121,12,70,62,144,35,35,57,108,17,13,",",265
"CC du Cellois, Coeur du Poitou, Mellois et du Val de Boutonne",257,882,367,1506,209,929,464,1602,254,309,690,1471,s.s,223,s.s,3108
CC du Centre Corse,43,129,63,235,50,177,78,305,129,38,121,130,s.s,52,s.s,540
CC du Centre du Haut-Rhin,86,273,129,488,83,299,123,505,71,106,212,471,s.s,69,s.s,993
CC du Chaourçois et du Val d'Armance,43,206,99,348,52,247,156,455,47,58,140,398,s.s,94,s.s,803
CC du Chemin des Dames,34,137,64,235,40,143,65,248,27,46,90,230,46,44,",",483
CC du Châtillonnais en Berry,49,110,56,215,36,101,78,215,19,36,82,220,40,33,",",430
CC du Civraisien en Poitou,172,465,214,851,137,523,280,940,138,181,357,892,s.s,116,s.s,1791
CC du Clermontais,242,926,404,1572,202,1057,436,1695,294,376,777,1397,s.s,231,s.s,3267
CC du Clermontois,252,874,282,1408,261,830,311,1402,201,284,662,1162,240,246,15,2810
CC du Clunisois,60,242,91,393,66,252,132,450,107,129,198,310,s.s,62,s.s,843
CC du Confluent et des Coteaux de Prayssas,108,538,275,921,114,648,292,1054,105,151,337,660,s.s,576,s.s,1975
CC du Cordais et du Causse (4 C),22,103,69,194,10,112,60,182,65,52,98,127,17,17,",",376
CC du Crestois et de Pays de Saillans Coeur de Drôme,135,588,220,943,109,615,274,998,353,253,414,653,s.s,168,s.s,1941
CC du Créonnais,91,386,152,629,100,498,212,810,151,189,349,606,s.s,77,s.s,1439
CC du Cubzaguais,187,855,272,1314,220,1214,454,1888,237,308,762,1463,s.s,257,s.s,3202
CC du Diois,62,422,192,676,52,461,191,704,291,210,382,391,s.s,64,s.s,1380
CC du District Urbain de Faulquemont (Duf),156,535,184,875,152,592,263,1007,134,193,453,855,104,133,10,1882
CC du Doubs Baumois,82,272,144,498,70,377,181,628,85,121,211,536,s.s,108,s.s,1126
CC du Fronsadais,99,360,132,591,86,503,215,804,145,162,297,604,s.s,111,s.s,1395
CC du Frontonnais,115,445,205,765,139,688,281,1108,227,292,430,704,s.s,121,s.s,1873
CC du Genevois,130,960,340,1430,123,997,326,1446,580,375,592,985,134,191,19,2876
CC du Golfe de Saint-Tropez,550,2272,958,3780,498,2540,1136,4174,732,949,2100,2877,633,636,27,7954
CC du Grand Armagnac,55,244,174,473,62,340,257,659,71,81,226,449,s.s,188,s.s,1132
CC du Grand Autunois Morvan,254,783,382,1419,208,848,508,1564,196,282,609,1372,s.s,300,s.s,2983
CC du Grand Chambord,108,394,136,638,122,427,208,757,106,171,300,651,s.s,97,s.s,1395
CC du Grand Châteaudun,238,834,304,1376,225,912,435,1572,177,231,550,1289,s.s,409,s.s,2948
CC du Grand Langres,125,499,124,748,124,480,246,850,81,162,340,730,s.s,164,s.s,1598
CC du Grand Pic Saint-Loup,221,984,407,1612,187,1103,456,1746,868,597,775,905,117,85,11,3358
CC du Grand Pontarlier,145,722,281,1148,125,699,284,1108,196,243,466,962,s.s,253,s.s,2256
CC du Grand Roye,224,693,263,1180,228,761,370,1359,85,163,473,1239,s.s,302,s.s,2539
CC du Grand Saint Emilonnais,95,335,132,562,87,453,209,749,100,151,259,549,s.s,166,s.s,1311
CC du Grand Villefranchois,146,516,238,900,140,607,338,1085,207,248,470,842,s.s,120,s.s,1985
CC du Guillestrois et du Queyras,50,303,99,452,40,307,120,467,148,139,261,315,s.s,20,s.s,919
CC du Gâtinais en Bourgogne,84,335,172,591,89,424,212,725,69,150,271,612,s.s,119,s.s,1316
CC du Gévaudan,53,175,82,310,43,174,56,273,59,70,149,236,19,50,",",583
CC du Haut Allier,21,88,43,152,13,93,42,148,31,27,72,122,21,27,",",300
CC du Haut Lignon,38,125,85,248,39,160,105,304,63,70,126,208,s.s,37,s.s,552
CC du Haut Pays Bigouden,98,413,185,696,92,416,189,697,187,206,343,555,s.s,42,s.s,1393
CC du Haut Pays du Montreuillois,85,275,123,483,88,377,127,592,67,134,264,456,s.s,91,s.s,1075
CC du Haut Val d'Oise,219,955,363,1537,249,1088,301,1638,298,325,757,1095,s.s,429,s.s,3175
CC du Haut Vallespir,67,284,178,529,53,277,179,509,75,87,228,490,s.s,80,s.s,1038
CC du Haut-Chablais,35,281,86,402,44,299,107,450,115,145,207,303,s.s,45,s.s,852
CC du Haut-Jura (Arcade),50,263,135,448,41,199,130,370,55,75,169,323,s.s,134,s.s,818
CC du Haut-Poitou,212,746,278,1236,201,974,421,1596,261,356,643,1288,s.s,152,s.s,2832
CC du Jovinien,155,544,206,905,150,577,227,954,125,152,373,858,s.s,241,s.s,1859
CC du Kochersberg,69,311,156,536,81,382,172,635,238,201,252,397,s.s,36,s.s,1171
CC du Kreiz-Breizh (Cckb),86,418,204,708,109,415,219,743,136,152,395,595,s.s,75,s.s,1451
CC du Lac d'Aiguebelette (Ccla),23,105,44,172,24,115,59,198,76,62,81,119,s.s,16,s.s,370
CC du Lautrécois et du Pays d'Agout,69,307,129,505,81,366,171,618,140,158,271,451,s.s,62,s.s,1123
CC du Liancourtois,170,532,172,874,163,614,223,1000,119,228,433,769,s.s,176,s.s,1874
CC du Limouxin,174,680,370,1224,156,801,450,1407,222,287,619,1063,s.s,267,s.s,2631
CC du Massif du Sancy,68,203,92,363,62,279,189,530,82,95,229,359,s.s,59,s.s,893
CC du Massif du Vercors,49,274,115,438,43,288,161,492,180,172,227,293,s.s,29,s.s,930
CC du Mont des Avaloirs,75,322,119,516,99,282,146,527,55,86,201,501,s.s,104,s.s,1043
CC du Montbardois,74,233,117,424,82,246,136,464,56,60,178,432,s.s,102,s.s,888
CC du Nivernais Bourbonnais,20,87,46,153,27,92,59,178,16,32,63,166,26,28,",",331
CC du Nogentais,99,409,156,664,96,478,204,778,94,115,249,683,s.s,172,s.s,1442
CC du Nord Est Béarn,157,519,261,937,109,741,388,1238,284,324,489,908,s.s,91,s.s,2175
CC du Pays Arnay Liernais,34,103,58,195,46,116,84,246,34,40,105,196,s.s,49,s.s,441
CC du Pays Beaume-Drobie,70,318,148,536,68,312,161,541,134,124,286,435,s.s,49,s.s,1077
CC du Pays Bellegardien (Ccpb),127,626,217,970,119,603,212,934,159,197,413,769,s.s,233,s.s,1904
CC du Pays Bigouden Sud,221,776,360,1357,179,861,517,1557,438,411,720,1109,122,104,10,2914
CC du Pays Châtillonnais,130,413,228,771,97,458,291,846,75,120,284,786,s.s,226,s.s,1617
CC du Pays Entre Loire et Rhône,67,221,134,422,57,288,132,477,56,105,201,410,s.s,77,s.s,899
CC du Pays Fertois,164,625,238,1027,175,766,275,1216,203,218,529,875,s.s,214,s.s,2243
CC du Pays Fertois et du Bocage Carrougien,28,76,42,146,30,76,50,156,17,27,70,152,15,21,",",302
CC du Pays Fléchois,221,550,214,985,200,615,344,1159,135,168,433,993,s.s,249,s.s,2144
CC du Pays Fouesnantais,137,518,242,897,130,633,339,1102,332,323,518,680,s.s,65,s.s,1999
CC du Pays Foyen,129,471,249,849,110,514,259,883,100,96,335,703,s.s,343,s.s,1732
CC du Pays Gentiane,21,63,32,116,18,88,56,162,22,17,79,123,s.s,15,s.s,278
CC du Pays Grenadois,47,125,67,239,44,200,97,341,51,68,131,274,21,35,",",580
CC du Pays Haut Val d'Alzette,98,672,255,1025,91,630,232,953,144,165,444,810,127,276,12,1978
"CC du Pays Houdanais (C,C,P,H,)",107,386,194,687,100,498,255,853,297,271,349,468,s.s,86,s.s,1540
CC du Pays Loudunais,177,605,269,1051,174,757,372,1303,106,172,449,1234,s.s,251,s.s,2354
CC du Pays Morcenais,56,198,106,360,59,273,128,460,60,75,167,378,s.s,89,s.s,820
CC du Pays Mornantais (Copamo),96,388,187,671,126,483,210,819,308,253,344,475,46,64,",",1490
CC du Pays Noyonnais,310,1101,399,1810,293,1203,445,1941,164,299,782,1682,s.s,513,s.s,3751
CC du Pays Orne Moselle,326,1449,587,2362,330,1508,786,2624,336,457,1070,2401,257,454,11,4986
CC du Pays Rhénan,161,501,334,996,145,676,409,1230,205,219,391,1087,s.s,196,s.s,2226
CC du Pays Ribéracois,93,383,203,679,88,449,239,776,110,158,308,644,s.s,138,s.s,1455
CC du Pays Rignacois,18,79,40,137,22,106,44,172,32,47,64,141,s.s,13,s.s,309
CC du Pays Riolais,41,195,75,311,67,295,114,476,87,104,173,339,43,41,",",787
CC du Pays Rochois,78,522,195,795,90,581,214,885,255,251,367,594,s.s,141,s.s,1680
CC du Pays Roussillonnais,364,1103,413,1880,348,1489,603,2440,279,462,928,1699,325,608,19,4320
CC du Pays Réthelois,158,615,272,1045,163,765,301,1229,107,212,470,1116,s.s,229,s.s,2274
CC du Pays Solesmois,118,425,169,712,109,443,199,751,91,140,342,661,s.s,161,s.s,1463
CC du Pays Tarusate,111,391,169,671,66,494,214,774,74,161,319,675,s.s,117,s.s,1445
CC du Pays Viganais,72,366,199,637,56,308,159,523,138,118,290,424,s.s,93,s.s,1160
CC du Pays d'Alésia et de la Seine,39,124,65,228,47,146,84,277,42,35,89,260,s.s,55,s.s,505
CC du Pays d'Ancenis,347,1282,461,2090,396,1882,645,2923,484,630,1219,2147,212,308,13,5013
CC du Pays d'Etain,43,153,66,262,47,182,84,313,25,59,97,315,s.s,32,s.s,575
CC du Pays d'Iroise,237,703,311,1251,213,889,505,1607,468,430,729,1024,78,106,23,2858
CC du Pays d'Issoudun,207,553,220,980,166,451,252,869,100,135,394,931,s.s,154,s.s,1849
CC du Pays d'Olmes,101,428,281,810,74,416,319,809,79,142,346,740,s.s,174,s.s,1619
CC du Pays d'Oloron et des Vallées du Haut Béarn,185,712,333,1230,166,805,473,1444,265,306,585,1246,s.s,161,s.s,2674
CC du Pays d'Othe Aixois,51,177,88,316,41,200,116,357,49,45,119,306,70,84,",",673
CC du Pays d'Urfé,15,70,45,130,26,87,60,173,19,37,60,139,s.s,28,s.s,303
CC du Pays d'Uzerche,45,127,87,259,39,148,82,269,46,58,127,232,s.s,44,s.s,528
CC du Pays d'huriel,41,143,83,267,34,169,87,290,35,58,114,289,s.s,29,s.s,557
CC du Pays d'héricourt,124,466,209,799,121,537,269,927,110,176,352,788,s.s,176,s.s,1726
CC du Pays de Barr,133,462,198,793,110,570,216,896,189,204,361,714,s.s,131,s.s,1689
CC du Pays de Bitche,174,547,440,1161,160,608,448,1216,147,228,475,1071,s.s,297,s.s,2377
CC du Pays de Bray,158,418,178,754,132,511,228,871,75,137,374,768,s.s,136,s.s,1625
CC du Pays de Bâgé et de Pont-De-Vaux,110,391,146,647,135,532,217,884,111,169,357,694,78,110,12,1531
"CC du Pays de Chalindrey, de Vannier Amance et de la Région de Bourbonne-Les-Bains",101,261,127,489,70,333,185,588,40,79,219,556,s.s,94,s.s,1077
CC du Pays de Château-Gontier,170,536,211,917,198,724,294,1216,198,180,441,938,s.s,211,s.s,2133
CC du Pays de Châteaugiron,125,415,125,665,118,517,178,813,264,253,379,460,s.s,72,s.s,1478
CC du Pays de Colombey et du Sud Toulois,66,177,83,326,52,258,103,413,45,84,170,340,s.s,57,s.s,739
CC du Pays de Conches,149,436,191,776,125,512,197,834,101,149,302,797,s.s,119,s.s,1610
CC du Pays de Craon,148,418,186,752,150,609,215,974,97,152,443,785,s.s,126,s.s,1726
CC du Pays de Cruseilles,41,259,117,417,54,290,103,447,196,129,181,292,s.s,42,s.s,864
CC du Pays de Dol et de la Baie du Mont Saint-Michel,113,460,215,788,142,603,249,994,135,179,419,766,s.s,156,s.s,1782
CC du Pays de Duras,21,111,60,192,31,138,71,240,34,44,87,165,s.s,63,s.s,432
CC du Pays de Falaise,195,641,270,1106,180,746,303,1229,148,151,500,1058,159,309,10,2335
CC du Pays de Fayence,178,555,302,1035,146,648,374,1168,233,299,529,846,s.s,160,s.s,2203
CC du Pays de Fénelon,48,191,120,359,60,244,147,451,63,94,182,359,s.s,61,s.s,810
CC du Pays de Gex,221,1833,719,2773,183,2021,590,2794,1435,740,1093,1641,243,383,32,5567
CC du Pays de Honfleur-Beuzeville,247,679,268,1194,221,871,390,1482,198,255,556,1164,218,275,10,2676
CC du Pays de Lalbenque-Limogne,31,176,99,306,27,202,132,361,93,87,163,257,s.s,31,s.s,667
CC du Pays de Lamastre,28,136,72,236,28,173,82,283,59,61,123,206,s.s,40,s.s,519
CC du Pays de Landerneau-Daoulas,287,943,348,1578,286,1260,470,2016,526,571,927,1332,s.s,123,s.s,3594
CC du Pays de Landivisiau,161,692,278,1131,213,981,346,1540,189,313,714,1196,s.s,117,s.s,2671
CC du Pays de Lanouaille,51,219,110,380,41,239,174,454,79,77,177,357,s.s,76,s.s,834
CC du Pays de Lapalisse,44,156,105,305,41,190,114,345,31,43,131,325,s.s,56,s.s,650
CC du Pays de Lauzun,47,201,97,345,39,221,143,403,47,68,133,364,51,85,",",748
CC du Pays de Limours (Ccpl),66,267,154,487,52,291,166,509,249,174,222,268,s.s,42,s.s,996
CC du Pays de Loiron,83,242,90,415,101,374,118,593,82,123,250,446,45,62,",",1008
CC du Pays de Lubersac-Pompadour,27,119,64,210,45,156,81,282,41,53,116,189,s.s,56,s.s,492
CC du Pays de Lumbres,166,457,172,795,186,615,205,1006,109,203,493,761,s.s,140,s.s,1801
CC du Pays de Lunel,469,1974,871,3314,377,1930,823,3130,533,655,1439,2429,477,871,40,6444
CC du Pays de Lure,155,505,210,870,127,518,261,906,90,171,334,803,s.s,240,s.s,1776
CC du Pays de Luxeuil,78,416,159,653,76,390,195,661,52,114,237,646,s.s,167,s.s,1314
CC du Pays de Mauriac,33,105,54,192,23,99,75,197,22,31,72,198,s.s,22,s.s,389
CC du Pays de Maîche,62,359,166,587,72,428,185,685,73,100,271,583,s.s,124,s.s,1272
CC du Pays de Meslay-Grez,52,243,91,386,72,325,122,519,65,86,195,428,s.s,65,s.s,905
CC du Pays de Mirepoix,63,249,143,455,50,318,179,547,112,121,228,383,s.s,70,s.s,1002
CC du Pays de Montbozon et du Chanois,38,102,41,181,30,131,60,221,26,41,91,189,s.s,25,s.s,402
CC du Pays de Montfaucon,35,107,75,217,34,142,84,260,27,48,113,222,s.s,36,s.s,477
CC du Pays de Montmédy,26,128,69,223,25,139,65,229,32,29,104,222,s.s,39,s.s,452
CC du Pays de Mormal,302,1127,425,1854,313,1184,514,2011,321,363,851,1671,226,421,12,3865
CC du Pays de Mortagne,150,397,160,707,180,581,289,1050,140,230,486,684,92,114,11,1757
CC du Pays de Niederbronn-Les-Bains,136,455,218,809,128,471,232,831,86,120,270,876,s.s,172,s.s,1640
CC du Pays de Phalsbourg,93,247,127,467,84,339,194,617,67,93,251,496,s.s,101,s.s,1084
CC du Pays de Pierrefontaine - Vercel,91,341,151,583,91,467,193,751,107,146,288,575,s.s,127,s.s,1334
CC du Pays de Pontchâteau St Gildas des Bois,204,684,225,1113,273,1085,360,1718,178,322,719,1366,123,100,23,2831
CC du Pays de Pouzauges,131,368,143,642,183,552,251,986,113,166,381,727,s.s,119,s.s,1628
CC du Pays de Redon,411,1555,735,2701,465,1878,851,3194,547,633,1317,2690,349,330,29,5895
CC du Pays de Revigny Sur Ornain,49,130,80,259,31,157,75,263,27,40,112,239,s.s,69,s.s,522
CC du Pays de Ribeauvillé,74,297,119,490,71,354,159,584,115,161,216,461,s.s,64,s.s,1074
"CC du Pays de Rouffach, Vignobles et Châteaux",62,180,82,324,47,185,93,325,72,86,145,278,s.s,37,s.s,649
CC du Pays de Saint Aulaye,39,141,70,250,47,168,81,296,29,46,105,265,s.s,57,s.s,546
CC du Pays de Saint Yrieix,60,234,113,407,51,275,141,467,75,80,192,389,s.s,83,s.s,874
CC du Pays de Saint-Eloy,65,257,164,486,72,309,170,551,71,97,210,503,s.s,84,s.s,1037
CC du Pays de Saint-Fulgent - les Essarts,117,427,154,698,171,644,246,1061,112,217,436,780,s.s,109,s.s,1759
CC du Pays de Sainte-Odile,92,390,144,626,113,497,153,763,136,158,302,598,s.s,117,s.s,1389
CC du Pays de Salars,22,101,47,170,28,124,58,210,45,62,92,144,s.s,17,s.s,380
CC du Pays de Salers,24,95,69,188,22,137,104,263,38,39,90,219,s.s,29,s.s,451
CC du Pays de Sancey-Belleherbe,20,73,51,144,21,83,50,154,26,21,56,140,s.s,34,s.s,298
CC du Pays de Serres en Quercy,39,204,95,338,40,253,111,404,60,72,150,309,s.s,89,s.s,742
CC du Pays de Sommières,167,605,285,1057,130,719,347,1196,265,307,509,893,s.s,143,s.s,2253
CC du Pays de St Gilles-Croix-De-Vie,307,1042,545,1894,309,1338,837,2484,331,528,1036,1961,223,286,13,4378
CC du Pays de Stenay et du Val Dunois,67,207,90,364,45,204,110,359,28,47,141,368,s.s,76,s.s,723
CC du Pays de Tarascon,56,202,85,343,52,225,141,418,78,77,174,327,s.s,58,s.s,761
CC du Pays de Thelle et Ruraloise,374,1139,489,2002,333,1455,566,2354,353,556,1027,1849,s.s,268,s.s,4356
CC du Pays de Trie et du Magnoac,28,96,57,181,31,121,64,216,27,37,95,173,s.s,30,s.s,397
CC du Pays de Tronçais,34,152,115,301,22,136,99,257,41,52,101,265,36,63,",",558
CC du Pays de Valois,331,1101,457,1889,273,1324,584,2181,376,494,960,1577,281,365,17,4070
CC du Pays de Villeneuve en Armagnac Landais,39,94,67,200,29,139,86,254,29,48,97,208,s.s,44,s.s,454
CC du Pays de Villersexel,36,164,81,281,48,186,82,316,25,61,117,281,42,71,",",597
CC du Pays de Wissembourg,89,277,191,557,76,298,208,582,84,105,189,534,s.s,149,s.s,1139
CC du Pays de l'Arbresle (Ccpa),194,586,260,1040,165,757,362,1284,368,404,509,779,s.s,150,s.s,2324
CC du Pays de l'Ourcq,112,382,176,670,102,393,151,646,73,95,301,579,s.s,142,s.s,1316
CC du Pays de l'Ozon,99,385,162,646,92,463,187,742,226,214,313,497,s.s,80,s.s,1388
CC du Pays de l'huisne Sarthoise,199,542,232,973,207,800,353,1360,149,179,512,1051,s.s,263,s.s,2333
CC du Pays de la Châtaigneraie,72,256,141,469,91,340,176,607,64,101,223,530,s.s,81,s.s,1076
CC du Pays de la Serre,123,436,195,754,120,469,193,782,54,109,298,718,s.s,199,s.s,1536
CC du Pays de la Zorn,73,209,98,380,62,245,136,443,82,114,179,370,s.s,38,s.s,823
CC du Pays des Abers,189,670,297,1156,201,986,414,1601,358,389,723,1103,s.s,87,s.s,2757
CC du Pays des Achards,95,351,142,588,102,466,225,793,83,170,337,628,s.s,94,s.s,1381
CC du Pays des Ecrins,36,237,61,334,43,203,70,316,100,98,189,190,s.s,41,s.s,650
CC du Pays des Herbiers,153,577,169,899,217,745,325,1287,176,295,530,867,s.s,175,s.s,2186
CC du Pays des Lacs,31,117,49,197,25,141,62,228,41,72,89,177,s.s,24,s.s,425
CC du Pays des Paillons,139,499,246,884,131,558,259,948,175,212,431,748,s.s,128,s.s,1832
CC du Pays des Sorgues et des Monts de Vaucluse,205,940,387,1532,220,1055,493,1768,381,378,731,1261,s.s,341,s.s,3300
CC du Pays des Sources,131,457,185,773,135,584,223,942,109,215,378,755,s.s,123,s.s,1715
CC du Pays des Trois Rivières,226,773,256,1255,211,684,264,1159,67,168,416,1191,s.s,336,s.s,2414
CC du Pays du Coquelicot,187,633,290,1110,208,824,341,1373,133,225,523,1215,s.s,204,s.s,2483
CC du Pays du Neubourg,125,336,150,611,111,480,202,793,70,111,333,641,s.s,135,s.s,1404
CC du Pays du Saintois,60,252,88,400,64,260,120,444,59,102,198,393,s.s,44,s.s,844
CC du Pays du Sanon,38,99,43,180,30,124,46,200,22,42,108,162,s.s,16,s.s,380
CC du Pays du Vermandois,289,889,344,1522,235,938,416,1589,121,207,610,1483,s.s,388,s.s,3111
CC du Perche,136,438,176,750,149,482,242,873,102,144,320,714,s.s,178,s.s,1623
CC du Perche et Haut Vendômois,46,135,103,284,44,167,96,307,41,47,109,289,s.s,65,s.s,591
CC du Pilat Rhodanien,74,279,144,497,91,376,202,669,136,168,251,483,59,69,",",1166
CC du Pithiverais,204,737,321,1262,242,891,351,1484,141,206,555,1159,225,447,13,2746
CC du Pithiverais-Gâtinais,197,518,259,974,153,718,319,1190,116,205,485,930,178,240,10,2164
CC du Piémont Cévenol,135,620,295,1050,117,685,348,1150,259,265,519,828,s.s,201,s.s,2200
CC du Plateau Picard,261,688,254,1203,252,775,269,1296,106,198,549,1174,219,240,13,2499
CC du Plateau d'hauteville,22,103,46,171,19,85,50,154,27,38,82,131,s.s,23,s.s,325
CC du Plateau de Frasne et du Val de Drugeon (Cfd),20,105,47,172,18,133,61,212,34,30,93,176,s.s,30,s.s,384
CC du Plateau de Lannemezan,89,360,178,627,94,421,244,759,124,157,333,617,s.s,92,s.s,1386
CC du Plateau de Montbazens,19,81,25,125,23,118,36,177,32,49,73,123,11,14,",",302
CC du Plateau de Russey,16,100,68,184,28,115,53,196,32,38,59,178,s.s,40,s.s,380
CC du Pont du Gard,161,655,309,1125,148,805,370,1323,246,294,539,1007,s.s,216,s.s,2448
CC du Provinois,213,726,295,1234,219,847,370,1436,180,252,633,1126,206,261,12,2670
CC du Périgord Nontronnais,66,239,139,444,63,282,183,528,84,84,227,416,s.s,87,s.s,972
CC du Quercy Blanc,27,161,100,288,22,159,105,286,45,67,130,250,s.s,49,s.s,574
CC du Quercy Caussadais,148,510,220,878,156,684,264,1104,119,176,427,873,s.s,241,s.s,1982
CC du Quercy Rouergue et des Gorges de l'Aveyron,42,173,102,317,28,232,110,370,85,81,165,265,s.s,51,s.s,687
CC du Rhône Aux Gorges de l'Ardèche,176,552,276,1004,155,672,341,1168,169,234,459,904,s.s,254,s.s,2172
CC du Ried de Marckolsheim,106,358,162,626,103,466,239,808,78,125,286,728,s.s,113,s.s,1434
CC du Romorantinais et du Monestois,217,825,371,1413,218,879,429,1526,126,217,490,1425,s.s,418,s.s,2939
CC du Rouillacais,53,232,89,374,69,277,139,485,47,96,178,415,s.s,66,s.s,859
CC du Royans-Vercors,41,210,90,341,36,242,116,394,92,69,154,323,s.s,47,s.s,735
CC du Réolais en Sud Gironde,155,671,284,1110,153,739,342,1234,177,209,477,1044,s.s,280,s.s,2344
CC du Réquistanais,18,53,20,91,s.s,62,43,114,23,29,42,86,16,s.s,s.s,205
CC du Sammiellois,54,194,105,353,53,204,132,389,33,47,143,374,s.s,80,s.s,742
CC du Sartenais Valinco,75,289,144,508,78,362,178,618,96,101,235,354,s.s,242,s.s,1126
CC du Saulnois,172,496,256,924,149,570,252,971,111,164,456,890,s.s,144,s.s,1895
CC du Saves,42,119,76,237,38,202,125,365,67,77,149,262,s.s,19,s.s,602
CC du Secteur de Saint Loubes,148,575,222,945,175,740,277,1192,255,285,495,836,s.s,155,s.s,2137
CC du Seignanx,176,633,229,1038,173,809,298,1280,306,352,585,893,s.s,92,s.s,2318
CC du Serein,22,99,73,194,34,122,51,207,32,36,99,191,18,25,",",401
CC du Sisteronais-Buëch,173,711,306,1190,150,705,379,1234,209,226,565,997,s.s,248,s.s,2424
CC du Sor et de l'Agout,151,460,210,821,134,581,251,966,165,207,431,803,s.s,92,s.s,1787
CC du Sud Avesnois,318,959,364,1641,268,925,363,1556,79,194,617,1626,s.s,429,s.s,3197
CC du Sud Corse,216,844,307,1367,203,1085,372,1660,239,318,738,988,267,456,21,3027
CC du Sud Est du Pays Manceau,90,271,97,458,102,359,151,612,93,129,267,476,s.s,60,s.s,1070
CC du Sud Estuaire,169,656,236,1061,198,770,354,1322,233,299,579,1074,s.s,91,s.s,2383
CC du Sud Gironde,257,1140,453,1850,248,1430,627,2305,314,449,844,1764,s.s,520,s.s,4155
CC du Sud Grésivaudan,282,845,432,1559,274,1167,494,1935,346,426,822,1395,221,271,13,3494
CC du Sud Marnais,43,169,52,264,36,191,86,313,21,42,88,298,s.s,87,s.s,577
CC du Sud Messin,82,219,98,399,68,306,134,508,78,131,220,387,s.s,47,s.s,907
CC du Sud Territoire,134,602,251,987,156,609,336,1101,140,178,393,1022,s.s,210,s.s,2088
CC du Sud-Artois,182,535,216,933,160,686,294,1140,107,187,443,978,s.s,212,s.s,2073
CC du Ternois,274,890,317,1481,287,878,327,1492,127,246,723,1361,195,305,16,2973
CC du Terrassonnais en Périgord Noir Thenon Hautefort,117,488,245,850,109,587,331,1027,118,180,396,894,s.s,170,s.s,1877
CC du Territoire Nord Picardie,255,894,400,1549,218,890,385,1493,176,263,617,1429,229,315,13,3042
CC du Territoire de Beaurepaire,87,294,169,550,96,397,199,692,63,112,258,532,s.s,163,s.s,1242
CC du Territoire de Fresnes en Woëvre,27,77,39,143,26,98,46,170,18,40,79,144,17,15,",",313
CC du Territoire de Lunéville À Baccarat,291,1147,489,1927,304,1103,493,1900,184,306,828,1789,s.s,438,s.s,3827
CC du Thouarsais,241,773,335,1349,247,996,452,1695,148,242,564,1534,s.s,381,s.s,3044
CC du Triangle Vert,53,186,102,341,48,230,125,403,40,78,152,366,s.s,63,s.s,744
CC du Trièves,33,224,85,342,34,239,102,375,146,108,190,223,s.s,22,s.s,717
CC du Val D Amboise,182,731,292,1205,201,853,390,1444,276,300,554,1148,s.s,242,s.s,2649
CC du Val Marnaysien,68,218,98,384,50,298,129,477,66,97,194,386,s.s,67,s.s,861
CC du Val d'Amour,37,135,60,232,43,179,72,294,42,60,104,249,s.s,36,s.s,526
CC du Val d'Argent,78,253,115,446,71,211,109,391,45,54,175,364,s.s,123,s.s,837
CC du Val d'Ay,27,109,45,181,31,137,47,215,30,49,104,173,23,17,",",396
CC du Val d'Essonne (Ccve),238,801,364,1403,207,950,406,1563,421,454,743,1006,148,176,18,2966
CC du Val d'Ille-Aubigné,173,661,211,1045,188,881,241,1310,413,362,565,811,92,96,16,2355
CC du Val d'Orne,24,99,59,182,23,118,62,203,28,31,76,176,22,52,",",385
CC du Val de Bouzanne,29,119,71,219,25,109,78,212,21,49,90,208,s.s,34,s.s,431
CC du Val de Cher,31,114,70,215,24,117,63,204,30,34,94,211,s.s,30,s.s,419
CC du Val de Drôme,193,777,348,1318,170,937,425,1532,328,404,612,1069,s.s,283,s.s,2850
CC du Val de Morteau,57,435,231,723,74,478,230,782,146,191,289,604,s.s,176,s.s,1505
CC du Val de Sarthe,186,435,188,809,211,634,298,1143,98,192,478,938,s.s,130,s.s,1952
CC du Val de Somme,193,521,247,961,142,622,233,997,129,189,462,822,s.s,178,s.s,1958
CC du Val de Sully,166,511,189,866,166,646,285,1097,117,198,387,890,s.s,230,s.s,1963
CC du Val de Vienne,47,231,98,376,53,298,127,478,93,96,206,348,s.s,61,s.s,854
CC du Val de l'Aisne,144,466,255,865,118,574,283,975,85,150,414,827,s.s,194,s.s,1840
CC du Val de l'Eyre,101,452,169,722,112,626,224,962,156,217,437,696,s.s,90,s.s,1684
CC du Val de l'Oise,137,424,190,751,109,466,199,774,69,117,298,738,s.s,184,s.s,1525
CC du Vallespir,129,635,306,1070,132,638,366,1136,165,182,548,1004,s.s,149,s.s,2206
CC du Vexin Normand,272,754,302,1328,248,954,393,1595,180,253,658,1275,s.s,324,s.s,2923
CC du Vexin-Thelle,132,364,153,649,109,468,203,780,124,169,334,586,s.s,114,s.s,1429
CC du Vexin-Val de Seine,90,355,154,599,86,370,187,643,145,148,271,506,s.s,85,s.s,1242
CC du Vimeu,188,586,212,986,175,661,240,1076,77,161,418,1001,s.s,210,s.s,2062
CC du Volvestre,171,620,333,1124,157,886,395,1438,273,329,618,1018,s.s,164,s.s,2562
CC du Warndt,148,576,185,909,129,535,259,923,80,134,432,845,s.s,208,s.s,1832
CC l'Orée de la Brie,86,472,191,749,120,487,203,810,189,231,381,507,s.s,153,s.s,1559
CC la Clayette Chauffailles en Brionnais,68,240,137,445,63,282,194,539,57,86,206,459,s.s,106,s.s,984
CC la Domitienne,229,715,328,1272,203,925,432,1560,192,293,665,1339,s.s,173,s.s,2832
CC la Grandvallière,33,112,35,180,23,107,63,193,41,39,76,156,s.s,35,s.s,373
CC la Rochefoucauld - Porte du Périgord,101,435,226,762,98,529,270,897,128,147,356,826,s.s,103,s.s,1659
CC la Septaine,52,152,73,277,52,278,111,441,42,88,152,350,s.s,48,s.s,718
CC le Dourdannais en Hurepoix (Ccdh),115,415,190,720,100,428,203,731,184,206,325,517,89,119,11,1451
CC le Dunois,31,144,74,249,33,151,69,253,17,43,108,250,s.s,47,s.s,502
CC le Gesnois Bilurien,174,537,224,935,208,785,308,1301,119,222,491,1097,s.s,168,s.s,2236
CC le Grand Charolais,191,722,398,1311,204,859,502,1565,173,245,571,1361,s.s,330,s.s,2876
CC le Grésivaudan,446,1641,721,2808,356,2027,946,3329,1274,978,1272,2052,236,314,11,6137
CC le Tonnerrois en Bourgogne,92,351,183,626,79,337,189,605,55,87,171,615,s.s,172,s.s,1231
CC les Avant-Monts,215,661,328,1204,179,810,411,1400,211,250,625,1191,s.s,162,s.s,2604
CC les Balcons du Dauphiné,445,1291,527,2263,453,1894,790,3137,460,673,1228,2327,316,376,20,5400
CC les Portes Briardes Entre Villes et Forêts,212,816,392,1420,165,887,363,1415,385,392,693,871,156,322,16,2835
CC les Portes de l'Ile de France,127,429,205,761,108,501,237,846,153,197,364,635,s.s,141,s.s,1607
CC les Trois Provinces,24,103,79,206,26,103,71,200,16,31,60,199,49,51,",",406
CC les Vals du Dauphiné,384,1249,475,2108,357,1592,636,2585,432,535,1019,2013,302,381,11,4693
CC les Versants d'Aime,39,215,53,307,36,212,75,323,84,98,171,201,s.s,42,s.s,630
CC les Villages de la Forêt,25,111,49,185,26,123,63,212,31,36,94,180,s.s,35,s.s,397
CU Angers Loire Métropole,2211,9313,2894,14418,2481,10011,3549,16041,4570,3539,6314,10466,1905,3554,111,30459
CU Caen la Mer,2084,8829,2568,13481,2012,8246,2722,12980,3768,2804,5544,9828,1447,2952,118,26461
CU Clermont Auvergne Métropole,1786,8231,2396,12413,1752,8433,2889,13074,4160,3003,5770,8704,1379,2382,89,25487
CU Grand Paris Seine et Oise,2301,12679,4395,19375,1999,11971,4168,18138,4770,4516,8072,11771,2356,5899,129,37513
CU Orléans Métropole,1877,9167,2816,13860,2005,9190,2942,14137,3762,3394,6322,9022,1766,3615,116,27997
CU Perpignan Méditerranée Métropole,2272,9802,4222,16296,2091,9401,4163,15655,2928,3173,7299,13009,2319,3102,121,31951
CU Saint-Etienne Métropole,2936,12292,4520,19748,2911,11687,4716,19314,4034,3661,8953,15626,2030,4613,145,39062
CU Tour(S) Plus,2217,9317,2949,14483,2321,9614,3173,15108,4921,3790,6701,9880,1578,2634,87,29591
CU d'Alençon,386,1415,516,2317,364,1359,515,2238,315,390,938,2107,s.s,509,s.s,4555
CU d'Arras,728,3290,1021,5039,744,3017,1121,4882,1038,1156,2207,4013,578,894,35,9921
CU de Dunkerque,1908,7197,2185,11290,1724,6635,2414,10773,1579,2038,4970,9760,1410,2226,80,22063
CU du Grand Dijon,1562,7429,2305,11296,1595,7344,2562,11501,3613,2821,4844,7669,1227,2547,76,22797
CU du Grand Reims,1958,8983,2713,13654,1673,8265,3096,13034,3292,2969,5728,9929,1775,2909,86,26688
CU le Creusot Montceau-Lès-Mines,642,2429,993,4064,609,2423,1293,4325,523,774,1812,3932,541,788,19,8389
CU le Mans Métropole,1827,6986,2285,11098,1845,7442,2646,11933,2409,2290,4905,9007,1521,2844,55,23031
Eurométropole de Strasbourg,3022,17272,5622,25916,2724,15443,5042,23209,8990,5592,9817,15862,3055,5659,150,49125
Montpellier Méditerranée Métropole,3630,18813,5603,28046,3625,17521,5319,26465,11713,7490,12651,14872,2810,4657,318,54511
Métropole Européenne de Lille,8050,41201,13249,62500,8001,37444,12630,58075,17831,13004,26538,41446,7954,13294,508,120575
Métropole Grenoble-Alpes-Métropole,2476,12011,3880,18367,2360,11729,4085,18174,7570,4324,7564,11199,2022,3753,109,36541
Métropole Nice Côte d'Azur,3059,17170,7622,27851,2787,16830,7185,26802,8891,6697,12351,16791,3881,5882,160,54653
Métropole Rouen Normandie,3942,16422,5428,25792,3966,15415,5551,24932,5708,5228,11601,18844,3523,5711,109,50724
Métropole d'Aix-Marseille-Provence,12351,60667,23911,96929,11627,60757,23514,95898,28607,22290,42349,66479,11080,21402,620,192827
Métropole de LYON,7800,43678,13481,64959,7695,41929,12865,62489,28881,16135,26832,36368,6487,12172,573,127448
Métropole du Grand Nancy,1551,8134,2503,12188,1460,6724,2275,10459,3978,2733,4912,7538,1226,2177,83,22647
Métropole du Grand Paris,25715,203881,88373,317969,25961,203080,78602,307643,172375,79379,130168,130040,33115,77635,2900,625612
Nantes Métropole,3905,20832,5689,30426,4025,20955,5978,30958,14227,8980,13407,17415,2640,4459,256,61384
Rennes Métropole,2750,13324,3133,19207,2966,12815,3429,19210,9307,5527,8524,10440,1583,2792,244,38417
Toulouse Métropole,5198,26872,7811,39881,5361,29612,8574,43547,18946,11847,18901,22154,3974,7372,234,83428
Hors EPCI,1280,5720,2576,9576,1355,6294,3160,10809,2524,2351,4625,8102,1203,1515,65,20385
