lib_epci,anc_moins_3_mois,anc_3_a_5_mois,anc_6_a_11_mois,anc_12_a_23_mois,anc_24_a_35_mois,anc_plus_36_mois,total
Bordeaux Métropole,17928,14431,13894,14854,6978,10256,78341
Brest Métropole,3981,3337,3153,3647,1883,2807,18808
CA Agglo Pays d'Issoire,997,769,793,890,493,818,4760
CA Agglo du Pays de Dreux,2136,1740,1967,2240,1114,1987,11184
CA Agglomération du Choletais,1786,1457,1424,1695,899,1467,8728
CA Alès Agglomération,2972,2248,2263,2497,1552,2540,14072
CA Amiens Métropole,3767,3028,3318,3729,1777,3335,18954
CA Annemasse- les Voirons-Agglomération,2290,1557,1608,1486,638,718,8297
CA Annonay Rhône Agglo,994,659,702,772,415,667,4209
CA Ardenne Métropole,2401,1893,2126,2454,1411,2553,12838
CA Arlysère,1313,733,779,712,343,358,4238
CA Bassin d'Arcachon Sud-Pôle Atlantique (Cobas),1401,1067,1065,1181,626,847,6187
"CA Beaune, Côte et Sud - Communauté Beaune-Chagny-Nolay",781,592,657,810,390,606,3836
CA Bergeracoise,1197,988,926,1084,605,918,5718
CA Bourges Plus,1859,1411,1503,1752,880,1423,8828
CA Cannes Pays de Lérins,5066,2910,2996,3222,1659,2189,18042
CA Cap Excellence,2533,2201,2615,2932,1736,4986,17003
CA Carcassonne Agglo,2651,1939,1806,2027,1134,1904,11461
CA Caux Vallée de Seine,1295,1026,1035,1339,770,1315,6780
CA Chambéry Métropole-Coeur des Bauges,2702,1853,1738,1878,941,1012,10124
CA Chartres Métropole,2169,1804,1789,2124,1127,1607,10620
CA Chauny Tergnier la Fère,1038,879,962,1144,612,1172,5807
CA Châteauroux Métropole,1377,1155,1203,1396,712,1173,7016
CA Civis (Communauté Intercommunale des Villes Solidaires),5121,5081,5757,7077,3636,10321,36993
CA Clisson Sèvre et Maine Agglo,714,617,621,725,366,561,3604
CA Coeur d'Essonne Agglomération,3383,2382,2377,2435,1048,1396,13021
CA Colmar Agglomération,2086,1523,1711,1846,926,1388,9480
CA Communauté Paris-Saclay,4534,3449,3486,3482,1464,2036,18451
CA Concarneau Cornouaille Agglomération,951,741,718,847,436,587,4280
CA Creil Sud Oise,2313,1750,1858,1862,911,1430,10124
CA Dinan Agglomération,1669,1303,1321,1603,887,1246,8029
CA Dracénoise,2510,1795,1720,1786,873,1221,9905
CA Durance-Lubéron-Verdon Agglomération,1497,1026,1112,1302,615,877,6429
CA Ecla (Espace Communautaire Lons Agglomération),691,476,450,491,209,228,2545
"CA Epernay, Coteaux et Plaine de Champagne",940,673,744,769,409,658,4193
CA Etampois Sud Essonne,1014,704,693,703,320,449,3883
CA Evreux Portes de Normandie,2022,1722,1767,1980,981,1685,10157
CA Flers Agglo,886,714,750,915,465,765,4495
CA Fougères Agglomération,854,720,771,802,400,576,4123
CA Fécamp Caux Littoral Agglomération,656,566,628,740,345,549,3484
CA Gap-Tallard-Durance,960,754,722,799,355,488,4078
CA Golfe du Morbihan - Vannes Agglomération,3150,2380,2307,2742,1329,1749,13657
CA Grand Auch Coeur de Gascogne,746,552,460,495,242,409,2904
CA Grand Belfort,2023,1630,1589,1678,821,1315,9056
CA Grand Lac- Communauté d'Agglomération du Lac du Bourget,1509,956,892,970,445,487,5259
CA Grand Montauban,1904,1432,1592,1707,778,1047,8460
CA Grand Paris Sud Seine Essonne Sénart,7476,5536,5540,5476,2480,3115,29623
CA Grand Sud Caraïbe,1958,1664,2022,2137,1385,4120,13286
CA Grand-Poitiers,3238,2749,2592,2776,1418,2065,14838
CA Guingamp-Paimpol Armor-Argoat Agglomération,1304,1052,1016,1174,651,1000,6197
"CA Havraise (Co,D,A,H,)",4986,4165,4318,4937,2534,5134,26074
CA Hermitage-Tournonais-Herbasse-Pays de Saint Félicien,1101,891,812,1007,486,794,5091
CA Hérault-Méditerranée,2919,1667,1592,1926,1008,1448,10560
CA Intercommunale de la Réunion Est (Cirest),3446,3424,3595,4496,2163,4833,21957
CA Intercommunale du Nord de la Réunion (Cinor),5484,5198,5383,6316,3110,7646,33137
CA Lannion-Trégor Communauté,1835,1237,1215,1446,764,1204,7701
CA Limoges Métropole,3450,2919,2790,3382,1651,3066,17258
CA Lisieux Normandie,1300,860,893,1001,481,770,5305
CA Loire Forez,1654,1320,1319,1390,706,1036,7425
CA Lorient Agglomération,3840,3021,2976,3535,1776,3118,18266
CA Luberon Monts de Vaucluse,1371,952,1084,1253,650,919,6229
CA Marne et Gondoire,1587,1252,1210,1224,543,756,6572
CA Maubeuge Val de Sambre,3081,2398,2536,2824,1542,3023,15404
CA Mauges Communauté,1397,1100,684,523,272,423,4399
CA Melun Val de Seine,3011,1962,1954,2043,928,1271,11169
CA Metz Métropole,4827,3769,3557,3711,1934,3331,21129
CA Mont de Marsan Agglomération,977,772,759,802,399,554,4263
CA Mont-Saint-Michel-Normandie,1281,881,902,925,496,703,5188
"CA Montargoise et Rives du Loing (A,M,E,)",1414,1129,1139,1316,712,1204,6914
CA Montluçon Communauté,1123,968,963,1095,622,1247,6018
CA Montélimar Agglomération,1530,1077,1137,1378,649,920,6691
CA Morlaix Communauté,1089,889,859,1135,557,855,5384
CA Moulins Communauté,1139,825,898,991,554,939,5346
CA Mulhouse Alsace Agglomération,6555,5059,4758,4922,2440,3711,27445
CA Mâconnais Beaujolais Agglomération,1607,1209,1194,1292,628,953,6883
CA Paris - Vallée de la Marne,4219,3021,3208,3270,1474,2074,17266
CA Pau Béarn Pyrénées,3145,2605,2495,2526,1266,1938,13975
CA Pays Foix-Varilhes,761,452,463,525,248,363,2812
CA Pays de Montbéliard Agglomération,2829,2182,2265,2270,1356,2189,13091
CA Plaine Vallée,3209,2391,2234,2282,1010,1578,12704
CA Pornic Agglo Pays de Retz,930,746,688,898,399,662,4323
"CA Porte de l'Isère (C,A,P,I)",2506,1758,1800,2048,889,1111,10112
CA Portes de France-Thionville,1417,1122,1091,1267,623,867,6387
CA Privas Centre Ardèche,909,602,589,723,317,488,3628
CA Provence-Alpes-Agglomération,1101,762,769,911,448,675,4666
CA Quimper Bretagne Occidentale,1831,1501,1463,1705,871,1339,8710
CA Rambouillet Territoires,926,729,693,774,351,485,3958
CA Roannais Agglomération,1817,1423,1454,1751,880,1493,8818
CA Rochefort Océan,1286,1087,993,1211,669,1052,6298
CA Rodez Agglomération,903,724,725,710,358,430,3850
CA Roissy Pays de France,8408,5717,6100,5967,2699,4142,33033
CA Royan Atlantique,2031,1315,1094,1406,752,892,7490
CA Saint Germain Boucles de Seine,4802,3724,3608,3974,1818,2732,20658
CA Saint-Brieuc Armor Agglomération,2696,2306,2345,2430,1250,2205,13232
CA Saint-Louis Agglomération,1355,990,1058,1112,516,577,5608
CA Saint-Lô Agglo,1163,903,921,1006,511,609,5113
CA Sarreguemines Confluences,1298,907,919,1045,528,878,5575
CA Saumur Val de Loire,1857,1459,1526,1758,995,2047,9642
CA Seine Eure,1304,1149,1108,1371,691,1338,6961
CA Seine Normandie Agglomération,1525,1241,1139,1320,668,1205,7098
CA Sud Sainte Baume,1233,826,843,927,442,655,4926
CA Tarbes-Lourdes-Pyrénées,4314,1989,1912,2143,1057,1920,13335
CA Terre de Provence,1397,882,1003,1030,480,700,5492
CA Territoire de la Côte Ouest (Tco),5841,6107,6747,8479,4116,10534,41824
CA Territoires Vendômois,844,734,699,845,435,763,4320
CA Thonon Agglomération,1847,1151,1165,1172,542,543,6420
CA Toulon Provence Méditerranée,9482,6618,6438,7450,3653,4949,38590
CA Troyes Champagne Métropole,3918,3143,3430,3440,1672,2711,18314
CA Tulle Agglo,640,492,498,578,267,436,2911
CA Val Parisis,4366,3631,3267,3608,1720,2673,19265
CA Val d'Europe Agglomération,538,432,354,402,178,224,2128
CA Val d'Yerres Val de Seine,3064,2242,2301,2284,1009,1342,12242
CA Val de Garonne Agglomération,1114,919,846,1071,607,820,5377
CA Valence Romans Agglo,4875,3610,3649,4282,1989,3415,21820
CA Valenciennes Métropole,4373,3478,3320,3832,2014,3699,20716
CA Var Esterel Méditerranée (Cavem),3442,1943,1850,1912,956,1123,11226
CA Ventoux-Comtat-Venaissin (Cove),1729,1277,1337,1437,803,1156,7739
"CA Versailles Grand Parc (C,A,V,G,P,)",3278,2390,2307,2491,1106,1660,13232
CA Vichy Communauté,1463,1147,1149,1426,811,1469,7465
CA Viennagglo,1340,1042,991,1059,467,618,5517
CA Villefranche Beaujolais Saône,1462,1055,1115,1251,573,796,6252
CA Vitré Communauté,1147,1102,1033,1128,581,575,5566
CA d'Agen,1857,1455,1466,1625,809,1193,8405
CA d'Arles-Crau-Camargue-Montagnette,2747,1709,1757,1728,904,1301,10146
CA d'Epinal,2079,1537,1481,1718,1002,1707,9524
CA d'hénin-Carvin,2577,2195,2144,2679,1447,2515,13557
CA de Bar-Le-Duc - Sud Meuse,578,484,450,567,281,496,2856
CA de Bastia,1092,632,565,609,278,304,3480
CA de Blois ''agglopolys'',2069,1486,1595,1799,896,1417,9262
"CA de Béthune-Bruay, Artois-Lys Romane",4807,3867,3969,4827,2669,4710,24849
CA de Béziers-Méditerranée,3683,2420,2365,2790,1338,2067,14663
CA de Cambrai,1669,1321,1411,1577,823,1748,8549
CA de Castres Mazamet,1738,1234,1223,1317,680,1260,7452
CA de Cergy-Pontoise,4478,3288,3402,3572,1554,2338,18632
"CA de Chaumont, du Bassin Nogentais et du Bassin de Bologne Vignory Froncles",778,583,596,526,281,427,3191
CA de Châlons-En-Champagne,1574,1134,1232,1185,606,1037,6768
CA de Forbach Porte de France,1899,1336,1414,1358,758,1321,8086
CA de Haguenau,1526,1186,1222,1361,747,1075,7117
CA de Laval,1585,1321,1373,1436,667,1011,7393
CA de Lens - Liévin,4663,3931,4190,4930,2690,5181,25585
CA de Longwy,1165,744,813,1005,467,830,5024
CA de Nevers,1201,914,919,911,459,695,5099
CA de Nîmes Métropole,6395,4868,4760,5077,2674,4328,28102
CA de Saint Quentin en Yvelines,4088,3015,3011,3058,1336,1718,16226
CA de Saint-Dizier Der et Blaise,1063,888,949,1032,527,979,5438
CA de Saint-Dié-Des-Vosges,1331,1003,1164,1425,820,1742,7485
CA de Saintes,1121,850,883,955,520,821,5150
CA de Sophia Antipolis,4582,2687,2580,3026,1419,1805,16099
CA de Vesoul,667,465,494,472,265,382,2745
CA de l'Albigeois (C2a),1680,1223,1296,1276,627,1001,7103
CA de l'Auxerrois,1135,940,949,948,569,874,5415
CA de l'Espace Sud de la Martinique,2880,2409,2505,2784,1583,3843,16004
CA de l'Ouest Rhodanien,762,602,620,723,368,524,3599
CA de la Baie de Somme,939,766,804,971,520,907,4907
CA de la Porte du Hainaut,3380,2700,2866,3395,1776,3246,17363
CA de la Presqu'île de Guérande Atlantique (Cap Atlantique),1628,997,904,1197,576,737,6039
CA de la Provence Verte,1986,1555,1552,1796,790,1085,8764
CA de la Riviera Française,1967,1016,1071,1160,520,635,6369
CA de la Rochelle,3354,2740,2522,3052,1560,2329,15557
CA de la Région Dieppoise,1061,769,791,899,453,1026,4999
CA de la Région Nazairienne et de l'Estuaire (Carene),2562,2017,2036,2199,1220,1830,11864
CA de la Région de Château-Thierry,1065,797,882,1074,541,932,5291
CA de la Région de Compiègne et de la Basse Automne,1488,1221,1307,1473,665,1099,7253
CA des Deux Baies en Montreuillois,1243,897,870,1147,612,1051,5820
CA du Bassin d'Aurillac,779,651,626,674,339,539,3608
CA du Bassin de Bourg-En-Bresse,2141,1646,1613,1898,878,1099,9275
CA du Bassin de Brive,1906,1465,1521,1829,933,1450,9104
CA du Bassin de Thau,3238,2193,2287,2626,1372,2251,13967
CA du Beauvaisis,2160,1628,1695,1788,944,1567,9782
CA du Bocage Bressuirais,1073,946,953,1114,565,792,5443
CA du Boulonnais,2499,2040,2050,2562,1298,2350,12799
CA du Calaisis,2265,2009,1708,2233,1138,2460,11813
CA du Centre Littoral,3772,3248,3092,2171,937,1512,14732
CA du Centre de la Martinique,3778,3084,3291,3594,1909,5026,20682
CA du Cotentin,2145,1707,1581,1816,950,1437,9636
"CA du Douaisis [c,A,D,]",2955,2645,2773,3144,1755,3411,16683
CA du Gard Rhodanien,1631,1221,1224,1399,697,969,7141
CA du Grand Angoulême,2869,2348,2306,2451,1322,2274,13570
CA du Grand Annecy,2301,1599,1503,1502,588,731,8224
CA du Grand Avignon (Coga),5090,3633,3957,4082,2123,3050,21935
CA du Grand Besançon,3871,2736,2762,2748,1324,1898,15339
CA du Grand Cahors,880,655,672,707,365,607,3886
CA du Grand Cognac,1244,994,1043,1182,591,888,5942
CA du Grand Dax,1422,935,883,1049,545,708,5542
CA du Grand Dole,1007,672,737,795,386,559,4156
CA du Grand Guéret,448,369,321,362,202,362,2064
CA du Grand Sénonais,1199,968,1068,1072,563,857,5727
CA du Grand Verdun,504,410,420,435,212,403,2384
CA du Grand Villeneuvois,998,759,731,934,512,655,4589
CA du Libournais,1901,1598,1636,1838,933,1459,9365
CA du Niortais,2056,1622,1644,1837,918,1331,9408
CA du Nord Basse-Terre,1876,1691,1858,2064,1168,3104,11761
CA du Nord Grande Terre,1324,1151,1381,1706,1046,3270,9878
CA du Pays Ajaccien,1958,878,869,851,382,490,5428
CA du Pays Basque,6704,4275,4262,4820,2276,3313,25650
CA du Pays Châtelleraudais,1478,1228,1166,1405,776,1213,7266
CA du Pays Nord Martinique,2613,2136,2060,2250,1286,3699,14044
CA du Pays Voironnais,1555,1177,1094,1230,571,666,6293
CA du Pays de Fontainebleau,983,681,706,712,341,515,3938
CA du Pays de Grasse,2264,1565,1590,1669,773,872,8733
CA du Pays de Laon,889,798,769,885,539,1067,4947
CA du Pays de Meaux,1922,1495,1598,1642,649,977,8283
CA du Pays de Quimperlé,897,783,759,947,488,670,4544
CA du Pays de Saint Malo - Saint Malo Agglomération,1771,1190,1241,1331,662,930,7125
CA du Pays de Saint-Omer,1910,1535,1541,1837,1000,1895,9718
CA du Pays de l'Or,1275,975,925,1034,486,782,5477
CA du Puy-En-Velay,1434,1043,1031,1254,597,987,6346
CA du Rabastinois - Tarn et Dadou - Vère Grésigne et Pays Salvagnacois,1484,1095,1181,1324,581,1124,6789
CA du Saint-Quentinois,1686,1464,1639,1794,997,2216,9796
CA du Sicoval,1157,988,1015,1060,485,782,5487
CA du Soissonnais,1172,834,995,1223,647,1281,6152
CA du Sud,3784,3661,3585,5292,2769,7369,26460
CA du Val de Fensch,1434,1226,1227,1283,653,1099,6922
CA la Riviéra du Levant,1731,1543,1613,1892,1113,3001,10893
CA la Roche Sur Yon - Agglomération,1719,1501,1525,1575,850,1307,8477
CA le Grand Chalon,1976,1563,1689,2007,1047,1587,9869
CA le Grand Narbonne,3187,2327,2333,2689,1462,2394,14392
CA le Grand Périgueux,1898,1476,1487,1623,795,1231,8510
CA le Muretain Agglo,2253,1806,1818,2056,1032,1583,10548
CA les Sables d'Olonne Agglomération,1014,712,702,856,508,771,4563
CC Adour Madiran,478,320,326,363,169,282,1938
CC Agglo Saint-Avold Centre Mosellan,1065,754,736,956,537,743,4791
CC Agly Fenouillèdes,138,94,97,128,91,113,661
CC Airvaudais-Val du Thouet,94,73,77,110,49,104,507
CC Albret Communauté,434,346,363,418,223,408,2192
CC Alpes d'Azur,153,117,145,133,53,91,692
"CC Alpes-Provence-Verdon ""sources de Lumière""",277,157,160,186,97,136,1013
CC Altitude 800,76,58,77,59,30,36,336
CC Ambert Livradois Forez,382,302,331,357,240,364,1976
CC Amognes Coeur du Nivernais,105,82,87,95,53,87,509
CC Andaine - Passais,238,120,113,117,57,80,725
CC Anjou Bleu Communauté,378,275,276,341,172,264,1706
CC Anjou Loir et Sarthe,383,310,367,403,254,417,2134
"CC Arbois, Poligny, Salins, Coeur du Jura",266,208,235,271,123,193,1296
CC Arc Sud Bretagne,441,314,384,417,213,287,2056
"CC Ardenne, Rives de Meuse",572,421,495,561,294,487,2830
CC Ardennes Thiérache,134,116,121,126,81,128,706
CC Ardèche Rhône Coiron,456,357,360,455,201,352,2181
CC Ardèche des Sources et Volcans,215,144,130,182,95,165,931
CC Argentan Intercom,471,387,390,422,227,314,2211
CC Argonne-Meuse,95,66,72,82,42,82,439
CC Arize Lèze,179,134,151,166,84,161,875
CC Armagnac Adour,102,52,78,100,45,60,437
CC Arnon Boischaut Cher,131,81,91,134,79,94,610
CC Artagnan de Fezensac,99,70,68,71,36,61,405
CC Arve et Salève,280,231,242,225,92,55,1125
CC Astarac Arros en Gascogne,89,82,79,77,46,70,443
CC Au Pays de la Roche Aux Fées,295,326,318,392,183,273,1787
CC Aubrac Lot Causse et Pays de Chanac,100,65,73,93,31,33,395
CC Aubrac et Carladez,112,72,52,64,28,48,376
CC Aunis Atlantique,528,429,422,483,213,357,2432
CC Aunis Sud,553,443,411,536,279,425,2647
CC Auray Quiberon Terre Atlantique,1960,1268,1176,1524,764,1114,7806
CC Aure Louron,173,103,162,159,76,97,770
CC Auxonne Pontailler Val de Saône,385,292,316,401,216,275,1885
CC Auzon Communauté,167,142,133,153,80,166,841
"CC Avallon, Vézelay, Morvan",346,252,293,256,131,141,1419
CC Aveyron Ségala Viaur,71,49,68,60,19,28,295
CC Avre Luce Noye,331,282,293,345,174,286,1711
CC Aygues-Ouvèze en Provence (Ccaop),344,325,308,333,167,199,1676
CC Bassée-Montois,304,270,245,274,136,236,1465
CC Bastides de Lomagne,145,121,93,131,62,111,663
CC Bastides et Vallons du Gers,95,75,83,98,48,77,476
CC Baugeois Vallée,485,417,369,402,218,442,2333
CC Bazois Loire Morvan,193,135,145,192,107,172,944
CC Beaucaire Terre d'Argence,939,657,704,820,454,552,4126
CC Beauce Val de Loire,264,247,258,285,162,252,1468
CC Beaujolais Pierres Dorées,601,419,425,521,240,262,2468
CC Berg et Coiron,172,107,111,152,72,122,736
CC Berry Grand Sud,162,141,149,174,91,191,908
CC Berry Loire Puisaye,292,251,267,331,188,356,1685
CC Berry-Loire-Vauvise,98,58,72,91,46,73,438
CC Billom Communauté,354,289,293,339,179,302,1756
CC Bièvre Isère,919,682,684,846,358,529,4018
CC Blangy-Pont l'Evêque Intercom,301,177,173,210,97,144,1102
CC Bouzonvillois-Trois Frontières,348,234,278,322,134,272,1588
CC Brenne - Val de Creuse,274,190,197,247,91,157,1156
CC Bresse Haute Seille,245,175,194,221,97,113,1045
CC Bresse Louhannaise Intercom',414,302,304,359,173,210,1762
CC Bresse Revermont 71,127,110,107,100,73,74,591
CC Bretagne Porte de Loire Communauté,443,399,389,450,221,351,2253
CC Bretagne Romantique,500,450,457,526,294,381,2608
CC Briance Combade,52,65,66,69,47,71,370
CC Briance Sud Haute Vienne,101,81,111,141,70,111,615
CC Brie Nangissienne,411,355,332,359,178,226,1861
CC Brie des Rivières et Châteaux,465,373,349,358,138,235,1918
CC Bruyères-Vallons des Vosges,224,183,203,251,123,289,1273
CC Bugey Sud,625,434,503,469,257,293,2581
CC Buëch-Dévoluy,153,126,140,156,80,110,765
CC Cagire Garonne Salat,292,185,237,279,146,285,1424
CC Campagne-De-Caux,182,171,167,209,112,142,983
CC Canaux et Forêts en Gâtinais,407,323,369,474,235,449,2257
CC Cap Sizun - Pointe du Raz,227,139,132,188,104,190,980
CC Capcir Haut Conflent,125,105,157,141,89,60,677
CC Carmausin-Ségala,562,388,421,478,279,392,2520
CC Carnelle Pays-De-France,411,288,299,288,140,215,1641
CC Castelnaudary Lauragais Audois,531,412,424,443,248,316,2374
CC Castillon/Pujols,428,332,323,373,184,265,1905
CC Causses Aigoual Cévennes,109,82,75,93,52,79,490
CC Causses et Vallée de la Dordogne,819,606,576,670,340,522,3533
CC Caux - Austreberthe,472,346,356,412,208,441,2235
CC Caux Estuaire,197,192,175,207,128,194,1093
CC Cazals-Salviac,88,60,71,70,36,62,387
CC Centre Morbihan Communauté,683,519,531,673,351,449,3206
CC Centre Tarn,165,143,150,161,82,123,824
"CC Chablis, Villages et Terroirs",198,134,172,180,94,129,907
CC Chabris - Pays de Bazelle,81,75,86,99,51,82,474
CC Challans-Gois Communauté,761,697,657,800,411,583,3909
CC Chalosse Tursan,383,310,339,361,209,274,1876
CC Champagnole Nozeroy Jura,361,246,238,283,128,124,1380
CC Champsaur-Valgaudemar,181,156,169,204,98,134,942
CC Charente-Arnoult-Coeur de Saintonge,286,226,231,275,146,208,1372
CC Charlieu-Belmont,319,290,264,351,198,282,1704
CC Chavanon Combrailles et Volcans,160,100,126,164,58,128,736
"CC Chinon, Vienne et Loire",417,277,294,369,192,261,1810
CC Châteaubriant-Derval,689,588,592,666,345,635,3515
"CC Chénérailles, Auzances/Bellegarde et Haut Pays Marchois",177,133,124,177,98,175,884
"CC Ciate, Bourganeuf/Royère-De-Vassivière",200,179,172,193,117,226,1087
CC Cingal-Suisse Normande,387,306,311,302,166,256,1728
CC Cluses-Arve et Montagnes,1222,769,731,787,405,570,4484
CC Coeur Côte Fleurie,510,281,237,312,179,272,1791
CC Coeur Haute Lande,301,275,274,296,165,221,1532
CC Coeur d'Astarac en Gascogne,121,92,93,96,52,95,549
"CC Coeur d'Ostrevent [c,C,C,O,]",1414,1188,1256,1460,805,1421,7544
CC Coeur d'Yvelines,516,412,413,433,176,257,2207
CC Coeur de Beauce,353,281,297,362,187,251,1731
CC Coeur de Berry,249,212,253,266,136,243,1359
CC Coeur de Brenne,67,49,34,61,34,53,298
CC Coeur de Charente,316,262,293,321,163,309,1664
CC Coeur de Chartreuse,262,195,190,207,88,131,1073
CC Coeur de France,290,290,252,283,178,335,1628
CC Coeur de Garonne,592,475,525,561,298,533,2984
CC Coeur de Lozère,233,177,124,173,78,73,858
CC Coeur de Maurienne Arvan,301,193,212,170,80,93,1049
CC Coeur de Nacre,412,304,306,351,195,236,1804
CC Coeur de Savoie,640,449,386,490,286,250,2501
CC Coeur de Sologne,144,120,130,170,88,135,787
CC Coeur de Tarentaise,263,114,136,111,38,44,706
CC Coeur de l'Avesnois,534,469,481,542,301,572,2899
CC Coeur du Perche,158,121,127,121,78,94,699
CC Coeur du Var,919,652,665,753,360,510,3859
CC Coeur et Coteaux du Comminges,783,548,585,731,315,644,3606
CC Combrailles Sioule et Morge,259,202,201,250,124,225,1261
CC Commentry Montmarault Néris Communauté,412,270,330,392,240,485,2129
CC Communauté Bray-Eawy,334,285,317,331,186,257,1710
CC Communauté Lesneven Côte des Légendes,450,363,318,427,227,308,2093
CC Communauté de Communes de Thann-Cernay,654,538,551,552,296,445,3036
CC Comtal Lot et Truyère,224,190,157,207,75,137,990
CC Conflent-Canigó,613,374,382,450,237,271,2327
CC Conques-Marcillac,151,111,94,108,60,72,596
CC Corbières Salanque Méditerranée,484,363,319,405,234,321,2126
CC Coteaux et Plaines du Pays Lafrançaisain,216,154,147,181,95,152,945
CC Coteaux et Vallées des Luys,120,93,107,100,64,67,551
CC Couesnon Marches de Bretagne,263,210,239,255,126,178,1271
CC Couserans-Pyrénées,719,480,504,540,256,479,2978
CC Coutances Mer et Bocage,789,578,540,677,318,463,3365
CC Creuse Grand Sud,191,154,177,185,126,248,1081
CC Cère et Goul en Carladès,64,42,45,72,27,58,308
CC Côte Landes Nature,325,176,165,207,108,132,1113
CC Côte Ouest Centre Manche,330,263,284,299,169,197,1542
CC Côte d'Albâtre,420,311,354,451,245,429,2210
CC Côte d'Emeraude,580,378,409,455,216,363,2401
CC Côtes de Champagne et Val de Saulx,183,136,183,188,88,131,909
CC Côtes de Meuse Woëvre,98,81,70,92,47,67,455
CC Decazeville Communauté,335,229,247,251,150,196,1408
CC Dieulefit-Bourdeaux,182,152,131,156,73,136,830
CC Dombes Saône Vallée,500,432,378,392,163,160,2025
CC Domfront Tinchebray Interco,233,178,182,192,83,155,1023
CC Douarnenez Communauté,334,282,321,379,190,360,1866
CC Dronne et Belle,166,106,104,123,61,83,643
CC Drôme Sud Provence,886,695,704,838,383,678,4184
CC Dômes Sancy Artense,190,109,104,144,67,108,722
CC Ecueillé-Valençay,130,133,113,138,77,137,728
CC Eguzon - Argenton - Vallée de la Creuse,302,246,259,322,180,259,1568
CC Elan Limousin Avenir Nature,339,319,295,370,200,328,1851
CC Enclave des Papes-Pays de Grignan,399,356,411,415,214,411,2206
CC Entr'allier Besbre et Loire,411,283,287,354,201,426,1962
CC Entre Aire et Meuse - Triaucourt-Vaubécourt,86,58,67,65,44,57,377
"CC Entre Arroux, Loire et Somme",310,261,261,286,165,291,1574
CC Entre Beauce et Perche,252,238,249,298,150,246,1433
CC Entre Dore et Allier,283,207,243,314,157,266,1470
CC Entre juine et Renarde (Ccejr),326,254,249,238,115,150,1332
CC Entre Saône et Grosne,160,99,123,168,89,127,766
CC Estuaire et Sillon,484,466,440,527,261,346,2524
CC Eure-Madrie-Seine,513,427,426,494,248,451,2559
CC Falaises du Talou,337,273,237,282,127,277,1533
CC Faucigny-Glières,562,373,338,364,166,226,2029
CC Fercher Pays Florentais,201,139,144,166,92,151,893
CC Fier et Usses,232,155,178,177,72,76,890
CC Flandre Lys,594,480,468,594,264,420,2820
"CC Forêts, Lacs, Terres en Champagne",96,100,86,105,40,63,490
"CC Forêts, Seine et Suzon",67,45,57,63,34,37,303
CC Fumel Vallée du Lot,430,326,389,410,210,340,2105
CC Gally Mauldre,189,177,175,234,94,143,1012
CC Gartempe - Saint Pardoux,74,47,70,67,30,61,349
CC Giennoises,558,414,414,506,237,508,2637
CC Gorges Causses Cévennes,201,92,77,95,37,37,539
CC Grand Orb Communauté de Communes en Languedoc,434,291,285,327,212,302,1851
CC Grand Sud Tarn et Garonne,793,653,660,779,357,541,3783
CC Grand-Figeac,702,470,453,506,230,323,2684
CC Gâtinais Val de Loing,308,237,257,258,114,204,1378
CC Haut - Bugey,1297,850,946,1062,526,663,5344
CC Haut Chemin-Pays de Pange,186,160,179,194,83,152,954
CC Haut Limousin en Marche,256,218,271,318,160,276,1499
CC Haut Nivernais-Val d'Yonne,136,122,156,155,62,159,790
CC Haut Val de Sèvre,405,374,353,423,239,333,2127
CC Haut-Jura Saint-Claude,378,289,305,340,156,215,1683
CC Haut-Léon Communauté,553,361,407,518,298,413,2550
CC Haute Maurienne Vanoise,133,80,100,62,33,33,441
CC Haute Sarthe Alpes Mancelles,324,254,268,351,193,293,1683
CC Haute Saulx et Perthois-Val d'Ornois,222,187,191,224,133,229,1186
CC Haute Vallée du Thoré,91,63,62,79,36,70,401
CC Haute-Corrèze Communauté,446,347,387,461,193,299,2133
CC Haute-Provence-Pays de Banon,191,151,153,192,82,142,911
CC Hautes Terres,163,117,113,102,40,74,609
CC Houve-Pays Boulageois,329,269,251,314,172,256,1591
CC Inter-Caux-Vexin,625,517,490,567,316,483,2998
CC Interco Normandie Sud Eure,778,621,599,683,348,677,3706
CC Intercom Bernay Terres de Normandie,829,667,712,837,477,1005,4527
CC Intercom de la Vire Au Noireau,719,545,450,429,243,432,2818
CC Interrégionale Aumale - Blangy-Sur-Bresle,364,246,283,354,217,338,1802
CC Isigny-Omaha Intercom,435,283,277,362,196,264,1817
CC Isle Double Landais,214,170,164,201,122,205,1076
CC Isle Vern Salembre en Périgord,254,244,249,289,196,288,1520
CC Isle et Crempse en Périgord,237,181,168,237,112,197,1132
CC Jabron-Lure-Vançon-Durance,91,66,71,84,42,65,419
CC Jalle-Eau-Bourde,398,363,312,372,203,255,1903
CC Jura Nord,172,130,123,158,70,127,780
CC Jura Sud,119,83,99,104,55,61,521
CC Lacs et Gorges du Verdon,237,117,123,146,69,117,809
CC Lamballe Terre et Mer,1035,809,804,1004,465,698,4815
CC Larzac et Vallées,106,54,43,81,31,44,359
CC Latitude Nord Gironde,392,321,319,399,205,318,1954
CC Lauragais Revel Sorezois,430,294,332,343,191,332,1922
CC Lavalette Tude Dronne,219,214,169,217,133,198,1150
CC Leff Armor Communauté,475,387,438,488,235,370,2393
CC Lieuvin Pays d'Auge,270,218,227,283,140,266,1404
CC Liffré-Cormier Communauté,343,270,252,263,159,170,1457
CC Loches Sud Touraine,810,623,611,768,432,641,3885
CC Lodévois et Larzac,333,269,272,275,155,272,1576
CC Loir-Lucé-Bercé,381,282,290,362,212,378,1905
CC Loire Layon Aubance,621,525,497,605,298,513,3059
CC Loire et Allier,78,58,52,59,34,51,332
CC Loire et Semène,276,223,254,292,130,227,1402
"CC Loire, Nièvre et Bertranges",265,224,252,244,129,230,1344
"CC Loire, Vignobles et Nohain",372,285,346,359,188,352,1902
CC Lot et Tolzac,121,92,102,128,60,79,582
CC Loudéac Communauté - Bretagne Centre,788,618,621,649,310,421,3407
CC Loue-Lison,312,241,265,279,127,164,1388
CC Loué - Brûlon - Noyen,275,247,230,281,142,192,1367
CC Lyon Saint Exupéry en Dauphiné,514,384,411,410,187,263,2169
CC Lyons Andelle,305,272,255,344,192,370,1738
CC Lèze Ariège,532,474,461,520,235,445,2667
CC Mad et Moselle,254,220,235,268,135,173,1285
CC Maine Coeur de Sarthe,240,218,199,242,148,215,1262
CC Maine Saosnois,430,355,384,401,223,409,2202
CC Maison de l'Intercommunalité de Haute Tarentaise,318,174,346,190,84,57,1169
CC Marche Occitane - Val d'Anglin,75,55,77,91,55,63,416
CC Marches du Velay-Rochebaron,455,332,360,432,206,423,2208
CC Maremne Adour Côte Sud,2032,1089,1085,1274,622,692,6794
CC Maurienne Galibier,85,66,83,56,26,32,348
CC Mayenne Communauté,508,415,396,421,209,300,2249
"CC Meurthe, Mortagne, Moselle",242,176,187,234,126,218,1183
CC Meuse Rognon,130,104,128,154,57,113,686
CC Midi Corrézien,199,146,170,161,80,166,922
CC Minervois Saint-Ponais Orb-Jaur,298,180,216,257,135,255,1341
CC Mirebellois et Fontenois,149,107,131,157,68,107,719
CC Mond'arverne Communauté,471,394,407,568,260,393,2493
CC Mont Lozère,83,39,43,51,30,37,283
CC Montfort Communauté,320,261,307,302,162,228,1580
CC Monts d'Arrée Communauté,143,91,104,151,80,122,691
"CC Monts, Rance et Rougier",89,66,84,92,41,65,437
CC Moret Seine et Loing,500,314,345,379,190,261,1989
CC Morvan Sommets et Grands Lacs,154,124,94,146,81,142,741
CC Moselle et Madon,357,360,338,347,164,230,1796
CC Moutierrois Talmondais,670,424,435,595,300,540,2964
CC Mâconnais - Tournugeois,276,189,231,248,120,175,1239
CC Méditerranée Porte des Maures,1173,626,592,799,447,446,4083
CC Médoc Atlantique,795,450,408,609,284,394,2940
CC Médoc Coeur de Presqu'ile,690,531,516,611,297,473,3118
CC Médoc Estuaire,420,396,359,375,204,262,2016
CC Médullienne,364,330,328,335,168,201,1726
CC Mézenc-Loire-Meygal,124,117,118,141,73,109,682
CC Nebbiu - Conca d'Oro,309,94,74,68,21,42,608
CC Neste Barousse,105,65,87,94,39,78,468
CC Nièvre et Somme,457,358,448,659,284,588,2794
CC Norge et Tille,144,125,135,140,76,97,717
CC Normandie-Cabourg-Pays d'Auge,566,376,409,458,234,318,2361
CC Océan Marais de Monts,470,328,270,352,196,248,1864
CC Orée de Bercé - Belinois,227,203,237,300,144,262,1373
CC Osartis Marquion,601,509,560,643,318,442,3073
CC Ouche et Montagne,112,92,108,133,58,109,612
CC Ouest Limousin,132,118,123,172,81,161,787
CC Pays Créçois,381,356,343,411,167,281,1939
"CC Pays Dunois, Pays Sostranien, Bénévent/Grand-Bourg",333,252,257,282,174,237,1535
CC Pays Forcalquier et Montagne de Lure,237,154,169,194,80,152,986
CC Pays Fort Sancerrois Val de Loire,237,179,230,272,140,238,1296
CC Pays Rhin - Brisach,499,364,308,469,198,280,2118
CC Pays Ségali,177,152,170,160,87,100,846
CC Pays Vaison Ventoux (Copavo),372,237,207,325,150,216,1507
CC Pays d'Apt-Luberon,811,429,506,549,279,401,2975
CC Pays d'Evian Vallée d'Abondance,855,587,548,593,247,239,3069
CC Pays d'Opale,458,376,306,420,231,506,2297
CC Pays d'Orthe et Arrigans,453,302,360,382,201,276,1974
CC Pays d'Uzès,539,365,397,455,234,396,2386
"CC Pays de Boussac, Carrefour des Quatre Provinces, Evaux-Les-Bains/Chambon-Sur-Voueize",263,203,178,244,127,206,1221
CC Pays de Chantonnay,307,291,319,300,169,279,1665
CC Pays de Coulommiers,771,568,560,653,263,354,3169
CC Pays de Fontenay-Vendée,634,500,509,551,329,534,3057
CC Pays de L?audunois et du Bassin de Landres,351,303,326,370,187,289,1826
CC Pays de Montereau,879,626,620,644,307,475,3551
CC Pays de Nay,360,296,317,353,209,280,1815
CC Pays de Nemours,569,382,383,436,227,338,2335
CC Pays de Nexon Monts de Chalus,134,124,138,174,81,150,801
CC Pays de Nérondes,75,46,61,77,46,71,376
CC Pays des Vans en Cévennes,239,146,152,175,91,171,974
CC Pays du Mont-Blanc,852,528,605,469,212,178,2844
CC Perthois-Bocage et Der,71,50,65,69,45,57,357
CC Petite Montagne,76,80,68,76,37,38,375
CC Picardie des Châteaux,269,239,257,338,171,312,1586
CC Piège Lauragais Malepère,316,235,236,257,147,178,1369
CC Plaine Limagne,291,228,242,309,181,287,1538
CC Plaines et Monts de France,276,201,213,246,95,154,1185
CC Plateau de Caux-Doudeville-Yerville,337,241,240,329,149,293,1589
CC Pleyben-Châteaulin-Porzay,355,270,286,346,188,317,1762
CC Poher Communauté,244,209,203,230,118,178,1182
CC Ponthieu-Marquenterre,609,372,449,582,278,424,2714
CC Pontivy Communauté,794,593,590,681,324,495,3477
CC Porte Océane du Limousin,338,310,348,404,239,391,2030
CC Porte d'Alsace - Largue,342,228,250,296,138,161,1415
CC Porte d'Aquitaine en Pays de Serres,76,64,81,89,22,55,387
CC Porte de Dromardèche,953,697,713,837,414,635,4249
CC Porte de Maurienne,117,72,84,92,48,43,456
CC Porte du Jura,162,119,100,104,54,60,599
CC Portes de la Creuse en Marche,82,64,71,108,51,98,474
CC Portes du Berry Entre Loire et Val d'Aubois,119,100,108,155,73,180,735
CC Presqu'île de Crozon-Aulne Maritime,424,325,304,372,194,298,1917
CC Provence Verdon,374,379,337,408,204,251,1953
CC Pré-Bocage Intercom,302,233,276,302,162,219,1494
CC Pyrénées Audoises,280,202,196,198,97,253,1226
CC Pyrénées Cerdagne,151,96,122,129,61,69,628
CC Pyrénées Haut Garonnaises,331,177,207,238,126,205,1284
CC Pyrénées Vallées des Gaves,476,204,220,231,120,167,1418
CC Pévèle-Carembault,1137,958,960,1205,632,984,5876
CC Quercy - Bouriane,185,111,138,179,75,127,815
CC Quercy Vert-Aveyron,410,365,305,386,198,250,1914
CC Questembert Communauté,373,314,318,363,204,279,1851
CC Rahin et Cherimont,173,114,143,159,108,214,911
CC Randon - Margeride,52,36,31,47,21,22,209
CC Retz en Valois,480,414,465,548,346,552,2805
"CC Rhony, Vistre, Vidourle",468,425,420,460,227,322,2322
CC Rhône Crussol,475,415,338,463,234,323,2248
CC Rhône Lez Provence,570,431,516,559,279,422,2777
CC Riom Limagne et Volcans,1001,756,804,955,495,836,4847
CC Rives de Moselle,925,748,743,917,422,677,4432
"CC Rives de Saône, Cc Saint Jean de Losne Seurre",314,268,277,322,152,261,1594
CC Rives de l'Ain - Pays du Cerdon,251,213,195,209,91,115,1074
CC Roi Morvan Communauté,418,323,335,413,225,367,2081
CC Roumois Seine,626,588,558,684,339,614,3409
CC Roussillon-Conflent,459,410,319,498,241,292,2219
CC Rurales de l'Entre-Deux-Mers,240,249,241,293,145,244,1412
"CC Région Lézignanaise, Corbières et Minervois",709,486,480,612,282,527,3096
"CC Saint Affricain, Roquefort, Sept Vallons",202,164,170,183,105,122,946
CC Saint Cyr Mère Boitier Entre Charolais et Mâconnais,80,90,80,110,49,70,479
CC Saint-Pourçain Sioule Limagne,476,383,410,509,280,464,2522
CC Sarlat-Périgord Noir,551,261,223,311,141,221,1708
CC Sarrebourg Moselle Sud,826,590,553,625,285,456,3335
CC Sauer-Pechelbronn,225,146,197,230,98,171,1067
CC Sauldre et Sologne,221,164,190,227,115,211,1128
CC Sausseron Impressionnistes,242,215,203,204,98,157,1119
CC Save Garonne et Côteaux de Cadours,532,437,417,476,238,313,2413
CC Saône Doubs Bresse,150,141,148,212,90,152,893
CC Saône-Beaujolais,662,537,490,570,276,404,2939
CC Seine et Aube,147,128,154,155,107,147,838
CC Senlis Sud Oise,356,298,285,338,151,219,1647
CC Serein et Armance,382,339,366,411,210,299,2007
CC Serre-Ponçon,357,251,330,345,172,181,1636
CC Serre-Ponçon Val d'Avance,142,93,116,136,69,77,633
CC Seulles Terre et Mer,163,164,144,196,108,112,887
CC Sidobre Val d'Agout-Vals et Plateaux des Monts de Lacaune,187,164,181,201,56,158,947
CC Somme Sud-Ouest,547,425,495,563,294,536,2860
CC Sud Côte Chalonnaise,161,120,117,176,95,115,784
CC Sud Nivernais,304,243,257,255,163,293,1515
CC Sud Retz Atlantique,450,403,372,457,223,347,2252
CC Sud Sarthe,447,373,398,518,281,546,2563
CC Sud Vendée Littoral,1006,755,802,919,487,788,4757
CC Sud-Hérault,328,257,271,321,172,271,1620
CC Sud-Roussillon,627,437,417,561,297,417,2756
CC Sumène - Artense,104,86,92,105,47,55,489
CC Sèvre et Loire,624,572,612,674,327,438,3247
CC Tannay-Brinon-Corbigny,96,65,79,113,63,113,529
CC Tarn-Agout,428,370,411,395,224,310,2138
CC Terre Lorraine du Longuyonnais,227,139,157,205,108,186,1022
CC Terre d'Eau,389,232,214,293,191,318,1637
CC Terre de Camargue,841,407,317,538,276,377,2756
CC Terre de Picardie,329,202,299,339,177,322,1668
CC Terres Touloises,754,561,542,618,317,477,3269
CC Terres de Bresse,300,269,302,345,193,249,1658
CC Terres de Chalosse,333,254,266,273,120,191,1437
"CC Terres de Montaigu, Cc Montaigu-Rocheservière",634,567,553,574,322,459,3109
CC Terres de Perche,205,202,230,234,132,179,1182
CC Terres de Saône,192,170,162,157,87,109,877
CC Terres des Confluences,1263,777,799,868,488,669,4864
CC Terres du Haut Berry,303,233,260,395,199,266,1656
CC Territoriale Sud-Luberon,463,360,404,403,212,263,2105
CC Terroir de Caux,545,399,457,576,294,487,2758
CC Thiers Dore et Montagne,678,551,674,782,414,777,3876
CC Thiérache Sambre et Oise,354,279,308,376,220,428,1965
CC Tille et Venelle,42,49,63,68,42,47,311
CC Touraine Ouest Val de Loire,522,403,480,556,340,464,2765
CC Touraine Val de Vienne,396,307,386,426,226,336,2077
CC Touraine Vallée de l'Indre,667,574,573,669,346,508,3337
CC Touraine-Est Vallées,492,449,411,476,262,307,2397
CC Usses et Rhône,311,232,233,224,99,103,1202
CC Val 81,76,52,71,68,38,48,353
CC Val Briard,428,339,332,380,157,223,1859
CC Val Eyrieux,166,128,107,190,107,140,838
CC Val Guiers,199,140,164,181,86,92,862
CC Val Vanoise Tarentaise,157,75,145,66,22,20,485
CC Val de Charente,260,187,210,217,110,207,1191
CC Val de Gers,117,95,97,116,60,100,585
CC Val de Gray,414,299,306,281,176,270,1746
CC Val de Gâtine,292,267,266,318,154,241,1538
CC Val de Ligne,142,100,109,121,70,146,688
CC Val de Meuse - Voie Sacrée,119,98,92,106,51,115,581
CC Val de Saône Centre,273,220,217,217,107,85,1119
CC Val de l'Indre - Brenne,194,183,150,210,94,159,990
CC Val Ès Dunes,240,232,224,237,120,199,1252
CC Val'aïgo,315,231,229,266,120,211,1372
CC Val-De-Cher-Controis,749,570,603,743,418,592,3675
CC Vallons de Haute-Bretagne Communauté,576,506,509,580,273,397,2841
CC Vallée de l'Ubaye - Serre-Ponçon,170,138,130,174,83,77,772
CC Vallée de l'hérault,792,643,646,695,373,615,3764
CC Vallée de la Dordogne et Forêt Bessède,190,104,104,138,61,105,702
CC Vallée des Baux-Alpilles (Cc Vba),620,356,371,405,177,293,2222
CC Vallées de l'Orne et de l'Odon,275,215,224,301,150,203,1368
CC Vallées et Plateau d'Ardenne,411,347,347,428,239,448,2220
CC Vals de Saintonge,877,721,736,958,509,897,4698
"CC Vendée, Sèvre, Autise",252,198,216,271,129,203,1269
CC Ventoux Sud,217,119,142,171,78,113,840
CC Vexin Centre,282,257,235,319,124,196,1413
CC Vienne et Gartempe,470,388,440,524,250,368,2440
CC Vierzon-Sologne-Berry,666,486,595,638,314,743,3442
CC Vézère-Monédières-Millesources,52,35,51,56,17,43,254
CC Xaintrie Val'dordogne,144,116,107,137,68,114,686
CC Yonne Nord,370,303,290,333,174,261,1731
CC d'Aire Sur l'Adour,197,136,150,181,73,139,876
CC d'Altkirch et Environs,706,509,537,582,300,354,2988
"CC d'Arcis, Mailly, Ramerupt",189,130,171,220,103,135,948
CC d'Auberive Vingeanne et Montsaugeonnais,133,92,108,100,29,63,525
CC d'Erdre et Gesvres,806,677,623,773,401,501,3781
CC de Bayeux Intercom,677,387,396,526,245,328,2559
CC de Belle Ile en Mer,222,57,56,104,47,50,536
CC de Bièvre Est,341,231,275,301,169,206,1523
CC de Blavet Bellevue Océan,255,204,219,274,156,205,1313
CC de Blaye,458,307,352,387,224,346,2074
CC de Bléré Val de Cher,354,229,248,305,165,224,1525
CC de Brocéliande,233,201,197,273,139,198,1241
CC de Calvi Balagne,1002,233,132,154,37,33,1591
CC de Cambremer,77,49,57,68,37,52,340
CC de Cattenom et Environs,264,215,207,264,94,145,1189
CC de Charente Limousine,478,400,430,487,280,403,2478
CC de Commercy - Void - Vaucouleurs,383,314,329,368,199,332,1925
CC de Cèze Cévennes,449,300,307,398,275,395,2124
CC de Damvillers Spincourt,123,91,86,120,48,97,565
CC de Desvres-Samer,338,268,296,353,177,314,1746
CC de Domme- Villefranche du Périgord,182,113,88,146,72,99,700
CC de Fium'orbu Castellu,364,242,139,167,89,75,1076
CC de Flandre Intérieure,1485,1198,1223,1390,673,1013,6982
CC de Forez-Est,944,741,790,780,381,550,4186
CC de Freyming-Merlebach,796,609,564,667,352,551,3539
CC de Gevrey-Chambertin et de Nuits-Saint-Georges,363,322,283,368,182,245,1763
CC de Grand Lieu,526,505,466,543,271,367,2678
"CC de Granville, Terre et Mer",689,561,565,625,319,486,3245
CC de Gâtine et Choisilles - Pays de Racan,274,224,197,297,156,234,1382
CC de Gémozac et de la Saintonge Viticole,263,206,253,259,132,215,1328
CC de Hanau- la Petite Pierre,370,249,297,335,199,305,1755
CC de Haute Cornouaille,257,191,205,238,139,207,1237
CC de Lacq-Orthez,921,622,655,794,417,669,4078
CC de Londinières,74,79,66,88,50,70,427
CC de Lévézou Pareloup,45,29,39,46,27,27,213
CC de Marana-Golo,551,295,265,309,137,129,1686
CC de Marie-Galante,254,255,227,251,131,356,1474
CC de Millau Grands Causses,670,466,448,487,254,350,2675
CC de Mimizan,327,212,187,251,136,140,1253
CC de Mirecourt Dompaire,299,202,199,242,166,291,1399
CC de Miribel et du Plateau,355,271,262,293,140,149,1470
CC de Montaigne Montravel et Gurson,186,169,172,228,100,162,1017
CC de Montbenoit,111,75,97,75,30,41,429
CC de Montesquieu,564,476,474,582,275,357,2728
CC de Noblat,125,129,142,204,92,179,871
CC de Parthenay-Gâtine,534,442,497,633,294,508,2908
CC de Petite Camargue,700,498,520,601,305,377,3001
CC de Ploërmel Communauté,648,527,517,544,310,412,2958
"CC de Podensac, des Coteaux de Garonne et de Lestiac-Sur-Garonne,paillet,rions",542,457,524,572,304,446,2845
CC de Pont-Audemer / Val de Risle,521,404,403,492,261,497,2578
CC de Portes Sud Périgord,139,96,85,109,58,102,589
CC de Pouilly en Auxois/Bligny Sur Ouche,132,86,90,112,63,93,576
CC de Puisaye-Forterre,494,362,376,436,210,377,2255
CC de Sablé-Sur-Sarthe,573,433,496,559,289,438,2788
CC de Saint-Méen Montauban,338,276,322,344,172,265,1717
CC de Saulieu,77,56,57,84,51,74,399
CC de Saverne-Marmoutier-Sommerau,558,451,524,502,267,389,2691
CC de Seille et Mauchère ? Grand Couronné,195,163,166,207,100,157,988
CC de Suippe et Vesle,84,62,84,90,47,57,424
CC de Sélestat,732,492,599,629,338,433,3223
CC de Sézanne-Sud Ouest Marnais,411,272,304,296,161,263,1707
CC de Vendeuvre-Soulaines,158,87,130,154,69,118,716
CC de Ventadour - Egletons - Monédières,125,102,108,152,84,115,686
CC de Vezouze en Piémont,169,135,141,208,107,244,1004
CC de Vie et Boulogne,638,584,564,611,338,489,3224
CC de Villedieu Intercom,246,169,198,212,127,151,1103
"CC de Vitry, Champagne et Der",550,352,379,423,219,377,2300
CC de Yenne,117,71,89,66,56,48,447
CC de l'Agglomération Migennoise,331,246,246,275,107,204,1409
CC de l'Aillantais,120,88,112,112,52,74,558
CC de l'Aire Cantilienne,584,476,481,531,259,389,2720
CC de l'Alsace Bossue,362,272,301,363,206,304,1808
CC de l'Alta Rocca,383,97,82,72,23,35,692
CC de l'Arc Mosellan,373,353,342,408,204,254,1934
CC de l'Argonne Ardennaise,260,168,214,175,102,136,1055
CC de l'Argonne Champenoise,198,140,133,154,71,138,834
CC de l'Ernée,268,197,194,199,99,143,1100
CC de l'Est Guyanais,216,153,178,101,52,91,791
CC de l'Est Lyonnais (Ccel),473,372,441,488,228,247,2249
CC de l'Est de la Somme,366,326,366,455,259,404,2176
CC de l'Estuaire - Canton de Saint Ciers Sur Gironde,330,288,287,334,147,299,1685
CC de l'Ile d'Oléron,780,353,293,415,162,264,2267
CC de l'Ile de Noirmoutier,279,140,83,149,73,112,836
CC de l'Ile de Ré,624,252,179,271,146,199,1671
CC de l'Ile-Rousse - Balagne,573,158,90,116,35,36,1008
CC de l'Oisans,233,163,231,153,69,56,905
CC de l'Oise Picarde,454,368,386,464,248,367,2287
CC de l'Oriente,168,71,86,60,39,35,459
CC de l'Orvin et de l'Ardusson,163,93,128,128,81,121,714
CC de l'Ouest Corse,371,64,55,89,38,41,658
CC de l'Ouest Guyanais,1329,986,931,913,365,499,5023
CC de l'Ouest Vosgien,349,293,298,379,201,393,1913
CC de l'Oust À Brocéliande Communauté,559,474,436,480,264,399,2612
CC de l'Outre-Forêt,227,187,191,214,130,143,1092
CC de la Baie du Cotentin,385,281,239,304,149,217,1575
CC de la Basse-Zorn,162,126,163,192,101,141,885
CC de la Beauce Loirétaine,178,152,181,249,150,198,1108
CC de la Brie Champenoise,114,97,122,106,44,91,574
CC de la Castagniccia-Casinca,301,179,157,193,89,85,1004
CC de la Champagne Conlinoise et du Pays de Sillé,265,240,221,282,162,218,1388
CC de la Champagne Picarde,272,288,276,345,202,435,1818
CC de la Châtaigneraie Cantalienne,250,206,169,208,123,151,1107
CC de la Châtre et Sainte Sévère,235,176,174,245,130,205,1165
"CC de la Cléry, du Betz et de l'Ouanne",338,274,295,351,188,288,1734
CC de la Costa Verde,301,125,115,139,66,73,819
CC de la Côtière À Montluel,398,307,308,296,123,141,1573
CC de la Dombes,512,399,404,412,210,201,2138
CC de la Forêt,201,154,172,211,120,163,1021
CC de la Gascogne Toulousaine,300,227,252,258,110,184,1331
CC de la Grande Vallée de la Marne,180,145,147,182,80,148,882
CC de la Haute Ariège,164,96,104,95,61,92,612
CC de la Haute Comté,307,198,275,214,139,262,1395
CC de la Haute Deûle,337,277,278,338,186,371,1787
CC de la Haute Saintonge,1166,939,965,1197,568,872,5707
CC de la Haute Somme,513,367,427,550,331,707,2895
CC de la Haute Vallée de Chevreuse,226,164,230,193,72,128,1013
CC de la Haute Vallée de l'Ognon,129,121,90,97,66,153,656
CC de la Haute Vallée de la Gravona,228,88,84,93,39,46,578
CC de la Haute-Bigorre,336,200,240,276,145,303,1500
CC de la Lomagne Gersoise,328,210,242,294,143,193,1410
CC de la Lomagne Tarn-Et-Garonnaise,176,136,130,143,66,87,738
CC de la Marche Berrichonne,52,45,51,59,36,48,291
CC de la Matheysine,303,218,218,269,130,200,1338
CC de la Moivre À la Coole,96,73,59,100,56,67,451
CC de la Montagne Noire,120,91,84,84,41,98,518
CC de la Montagne d'Ardèche,83,26,31,49,25,38,252
CC de la Mossig et du Vignoble,307,261,246,282,157,215,1468
CC de la Muse et des Raspes du Tarn,66,46,54,77,27,37,307
CC de la Picardie Verte,490,387,455,495,281,442,2550
CC de la Pieve de l'Ornano,360,138,110,124,54,81,867
CC de la Plaine Dijonnaise,269,190,233,314,163,266,1435
CC de la Plaine Jurassienne,103,91,103,129,64,81,571
CC de la Plaine d'Estrées,209,229,204,227,121,192,1182
CC de la Plaine de l'Ain,1376,1051,1128,1051,490,579,5675
CC de la Plaine du Nord Loiret,87,63,104,113,52,79,498
CC de la Plaine du Rhin,180,137,187,216,105,181,1006
CC de la Porte des Vosges Méridionales,533,425,411,457,238,483,2547
CC de la Région d'Audruicq,406,362,330,442,200,408,2148
CC de la Région d'Orgelet,98,46,60,52,22,25,303
CC de la Région d'Yvetot,435,320,297,403,189,416,2060
CC de la Région de Bar Sur Aube,263,124,184,181,141,215,1108
CC de la Région de Blain,234,199,212,271,148,197,1261
CC de la Région de Condrieu,211,194,188,210,94,140,1037
CC de la Région de Guebwiller,633,532,560,625,284,416,3050
CC de la Région de Levroux,84,67,94,86,52,69,452
CC de la Région de Molsheim-Mutzig,570,463,449,508,270,347,2607
CC de la Région de Nozay,191,194,208,210,112,178,1093
CC de la Région de Rambervillers,241,175,171,182,117,235,1121
CC de la Save Au Touch,653,525,546,602,297,331,2954
CC de la Sologne des Etangs,97,92,101,101,68,98,557
CC de la Sologne des Rivières,168,144,134,190,101,175,912
CC de la Station des Rousses-Haut Jura,160,118,112,101,37,39,567
CC de la Tenarèze,296,194,185,222,124,187,1208
CC de la Terre des Deux Caps,362,270,263,360,205,312,1772
CC de la Thiérache du Centre,382,405,459,457,269,550,2522
CC de la Vallée Verte,107,101,83,93,28,39,451
CC de la Vallée d'Ossau,193,118,118,134,68,108,739
CC de la Vallée de Chamonix-Mont-Blanc,410,219,191,158,52,41,1071
CC de la Vallée de Kaysersberg,228,160,154,195,83,130,950
CC de la Vallée de Munster,271,145,168,193,120,169,1066
CC de la Vallée de Saint-Amarin,198,162,127,192,95,145,919
CC de la Vallée de Villé,144,96,109,122,66,97,634
CC de la Vallée de l'Oise et des Trois Forêts,521,414,394,459,185,274,2247
CC de la Vallée de l'homme,416,216,189,243,127,184,1375
CC de la Vallée de la Bruche,331,256,283,312,193,306,1681
CC de la Vallée de la Doller et du Soultzbach,278,176,205,188,91,130,1068
CC de la Vallée de la Haute Sarthe,125,81,93,96,50,66,511
CC de la Vallée du Gapeau,517,386,376,398,205,311,2193
CC de la Vallée du Garon (Ccvg),370,309,273,348,123,190,1613
CC de la Vallée du Lot et du Vignoble,204,173,198,196,115,229,1115
CC de la Vanne et du Pays d'Othe,115,113,119,127,65,95,634
CC de la Veyle,303,219,240,315,130,165,1372
CC des 2 Vallées,226,168,169,186,84,112,945
CC des 4 Rivières,483,350,363,454,239,401,2290
CC des 4b Sud Charente,290,265,264,296,148,229,1492
CC des 7 Vallées,488,385,403,519,213,381,2389
CC des Albères et de la Côte Vermeille,1886,1062,1003,1237,643,833,6664
CC des Aspres,473,390,333,461,242,380,2279
CC des Ballons des Hautes-Vosges,257,184,209,258,163,280,1351
CC des Baronnies en Drôme Provençale,539,280,329,413,213,313,2087
CC des Bastides Dordogne-Périgord,332,214,224,243,131,204,1348
CC des Bastides en Haut Agenais Périgord,266,215,202,222,120,185,1210
CC des Campagnes de l'Artois,430,349,345,401,237,304,2066
CC des Causses À l'Aubrac,170,122,138,142,67,91,730
CC des Collines du Nord Dauphiné,289,266,297,317,139,126,1434
CC des Collines du Perche,70,69,59,80,45,89,412
CC des Collines du Perche Normand,163,158,142,136,67,107,773
CC des Combes,107,74,64,97,46,62,450
CC des Coteaux Arrats Gimone,147,104,118,149,73,85,676
CC des Coteaux Bellevue,233,231,203,248,116,158,1189
CC des Coteaux Bordelais,251,224,211,275,143,149,1253
CC des Coteaux de Pouyastruc et du Canton de Tournay,168,130,116,138,71,83,706
CC des Coteaux du Girou,270,247,226,281,144,203,1371
CC des Coteaux et Landes de Gascogne,195,173,176,199,99,159,1001
CC des Coëvrons,345,311,343,332,158,256,1745
CC des Crêtes Préardennaises,308,209,290,324,184,266,1581
CC des Cévennes Au Mont Lozère,72,63,58,74,28,64,359
CC des Cévennes Gangeoises et Suménoises,325,241,214,241,139,239,1399
CC des Deux Morin,386,290,362,359,173,256,1826
CC des Deux Rives,405,319,276,317,161,227,1705
CC des Deux Vallées,360,317,315,393,206,382,1973
CC des Deux Vallées Vertes,203,185,182,221,101,170,1062
CC des Forêts du Perche,96,88,99,143,77,92,595
CC des Gorges de l'Ardèche,594,313,240,377,192,289,2005
CC des Grands Lacs,818,536,480,555,283,314,2986
CC des Hautes Terres de l'Aubrac,43,32,30,33,22,25,185
CC des Hautes Vosges,573,424,464,517,280,521,2779
CC des Hauts de Flandre,689,545,556,699,425,624,3538
CC des Hauts du Perche,151,82,79,75,33,46,466
CC des Hauts du Val de Saône,119,84,98,102,62,81,546
CC des Lacs de Champagne,167,112,149,156,83,150,817
CC des Lacs et Montagnes du Haut-Doubs,283,190,242,264,69,70,1118
CC des Landes d'Armagnac,179,124,127,142,73,101,746
CC des Lisières de l'Oise,219,189,214,238,129,232,1221
CC des Loges,504,427,483,651,311,429,2805
CC des Luys en Béarn,355,310,330,349,181,196,1721
"CC des Marchés du Périg Or Limousin, Thiviers-Jumilhac",201,172,172,186,101,132,964
CC des Montagnes du Giffre,228,139,179,153,77,88,864
CC des Monts d'Alban et du Villefranchois,78,72,72,65,36,50,373
CC des Monts de Gy,89,74,84,70,34,53,404
CC des Monts de Lacaune et de la Montagne du Haut Languedoc,126,82,72,105,53,83,521
CC des Monts du Lyonnais,340,255,319,312,164,215,1605
CC des Monts du Pilat,200,135,144,168,85,144,876
CC des Pays d'Oise et d'halatte,518,475,524,565,254,398,2734
"CC des Pays de Briey, du Jarnisy et de L?orne",952,719,744,826,476,761,4478
"CC des Pays de Caldaguès-Aubrac, Pierrefort-Neuvéglise, Planèze, Saint-Flour Margeride",358,220,198,203,93,152,1224
CC des Pays de Cayres et de Pradelles,71,36,42,66,23,52,290
CC des Pays de Rhône et Ouvèze,1106,889,926,1033,478,700,5132
CC des Pays de l'Aigle,461,349,353,368,184,281,1996
CC des Pays du Sel et du Vermois,382,303,343,457,231,372,2088
CC des Paysages de la Champagne,300,271,245,252,142,188,1398
CC des Portes Euréliennes D Ile de France,773,648,690,824,437,595,3967
CC des Portes d'Ariège Pyrénées,895,657,657,652,345,445,3651
CC des Portes de Romilly Sur Seine,510,422,446,419,211,404,2412
CC des Portes de Rosheim,213,195,172,213,106,153,1052
CC des Portes de Sologne,178,129,172,200,99,162,940
CC des Portes de Vassivière,59,53,57,74,54,79,376
CC des Portes de l'Entre Deux Mers,309,264,271,323,152,265,1584
CC des Portes de la Thiérache,121,109,102,141,78,207,758
CC des Portes du Luxembourg,380,260,297,369,182,348,1836
CC des Quatre Rivières,447,340,336,339,154,179,1795
CC des Quatre Territoires,119,60,72,72,31,33,387
CC des Quatre Vallées,268,213,219,263,126,227,1316
CC des Rives du Haut Allier,264,216,204,236,106,253,1279
CC des Sablons,621,520,541,643,261,404,2990
CC des Savanes,1109,829,810,539,218,376,3881
CC des Sorgues du Comtat,1061,898,927,990,573,740,5189
CC des Sources de l'Orne,161,137,141,155,73,89,756
CC des Sources du Lac d'Annecy,274,212,183,206,90,123,1088
CC des Sucs,292,187,217,256,131,210,1293
CC des Terres d'Apcher-Margeride-Aubrac,141,76,81,103,44,65,510
CC des Terres d'Auxois,233,163,191,237,109,180,1113
CC des Terres du Lauragais,574,460,509,604,268,460,2875
CC des Terres du Val de Loire,633,523,646,746,357,557,3462
CC des Trois Forêts,109,75,97,88,39,57,465
CC des Vallons du Lyonnais (Ccvl),347,282,282,328,114,151,1504
CC des Vallées d'Aigueblanche,222,73,110,62,29,32,528
CC des Vallées d'Auge et du Merlerault,254,183,195,204,109,168,1113
CC des Vallées de Thônes,337,198,241,235,95,80,1186
CC des Vallées de la Braye et de l'Anille,197,179,176,213,109,200,1074
CC des Vallées de la Tille et de l'Ignon,145,135,164,189,90,145,868
CC des Vallées du Clain,288,253,246,326,138,227,1478
CC des Vallées du Haut-Anjou,478,402,391,405,247,309,2232
CC des Vals d'Aix et Isable,78,56,58,67,35,68,362
CC des Villes Soeurs,616,566,538,741,423,734,3618
CC des Vosges Côté Sud Ouest,189,121,128,184,100,183,905
CC des Vosges du Sud,237,164,157,187,96,155,996
CC du Barséquanais en Champagne,306,230,253,300,194,288,1571
CC du Bas Armagnac,130,94,88,107,66,87,572
CC du Bassin d'Arcachon Nord Atlantique (Coban Atlantique),1291,969,995,1110,565,736,5666
CC du Bassin d'Aubenas,988,715,683,778,403,763,4330
CC du Bassin de Joinville en Champagne,172,173,195,235,117,229,1121
CC du Bassin de Marennes,349,233,229,270,151,206,1438
CC du Bassin de Mortagne Au Perche,194,187,181,209,121,111,1003
CC du Bassin de Pompey,669,511,483,612,284,534,3093
CC du Bassin de Pont-À-Mousson,730,558,549,623,300,460,3220
CC du Bazadais,277,229,232,252,184,235,1409
CC du Bocage Bourbonnais,226,144,166,169,98,189,992
CC du Bocage Mayennais,207,153,178,214,105,159,1016
CC du Bonnevalais,176,140,135,177,89,137,854
CC du Briançonnais,527,346,438,357,205,227,2100
CC du Brivadois,296,255,239,263,129,257,1439
CC du Béarn des Gaves,237,180,213,221,126,155,1132
CC du Canton d'Erstein,677,492,574,643,266,412,3064
CC du Canton d'Oulchy le Château,90,80,84,109,56,104,523
CC du Canton de Charly Sur Marne,271,222,243,270,141,204,1351
CC du Canton de Criquetot-l'esneval,197,142,194,187,127,131,978
CC du Canton de Marcigny,75,62,65,83,36,77,398
CC du Canton de Pierre de Bresse,104,61,57,80,48,59,409
CC du Canton de Rumilly,530,363,327,389,148,202,1959
CC du Canton de Semur en Brionnais,64,52,66,65,32,50,329
CC du Canton de Vatan et de Champagne Berrichonne,130,128,138,133,87,119,735
CC du Canton de la Chambre,131,97,93,95,33,42,491
CC du Cap Corse,200,76,59,94,38,44,511
CC du Castelrenaudais,266,240,231,330,143,205,1415
CC du Caudrésis et du Catésis,1374,1139,1105,1365,800,1414,7197
CC du Causse de Labastide Murat,56,33,40,50,23,34,236
"CC du Cellois, Coeur du Poitou, Mellois et du Val de Boutonne",646,545,540,567,336,406,3040
CC du Centre Corse,176,88,73,86,39,38,500
CC du Centre du Haut-Rhin,209,187,176,200,77,141,990
CC du Chaourçois et du Val d'Armance,175,113,152,163,81,132,816
CC du Chemin des Dames,88,74,82,109,56,80,489
CC du Châtillonnais en Berry,82,79,68,78,44,79,430
CC du Civraisien en Poitou,316,282,340,349,186,282,1755
CC du Clermontais,633,527,544,600,317,490,3111
CC du Clermontois,582,550,521,518,228,368,2767
CC du Clunisois,208,141,132,172,81,104,838
CC du Confluent et des Coteaux de Prayssas,375,267,319,359,222,314,1856
CC du Cordais et du Causse (4 C),97,42,52,66,32,70,359
CC du Crestois et de Pays de Saillans Coeur de Drôme,401,295,312,315,171,287,1781
CC du Créonnais,265,227,271,307,139,215,1424
CC du Cubzaguais,609,569,539,615,273,437,3042
CC du Diois,333,208,197,253,121,186,1298
CC du District Urbain de Faulquemont (Duf),396,324,322,364,230,249,1885
CC du Doubs Baumois,221,200,194,218,110,139,1082
CC du Fronsadais,286,227,216,319,157,201,1406
CC du Frontonnais,403,317,292,367,171,243,1793
CC du Genevois,742,480,527,483,175,194,2601
CC du Golfe de Saint-Tropez,3586,1022,758,1193,479,485,7523
CC du Grand Armagnac,272,166,204,201,113,160,1116
CC du Grand Autunois Morvan,529,439,465,607,315,512,2867
CC du Grand Chambord,303,180,231,316,140,222,1392
CC du Grand Châteaudun,578,442,436,494,309,464,2723
CC du Grand Langres,383,263,306,299,159,225,1635
CC du Grand Pic Saint-Loup,675,552,586,635,302,469,3219
CC du Grand Pontarlier,626,388,415,397,186,201,2213
CC du Grand Roye,464,414,411,466,231,374,2360
CC du Grand Saint Emilonnais,286,236,217,234,125,165,1263
CC du Grand Villefranchois,467,332,395,381,175,246,1996
CC du Guillestrois et du Queyras,166,120,182,190,95,94,847
CC du Gâtinais en Bourgogne,258,227,243,260,137,201,1326
CC du Gévaudan,139,89,101,96,61,49,535
CC du Haut Allier,77,49,41,53,17,36,273
CC du Haut Lignon,123,72,87,112,51,95,540
CC du Haut Pays Bigouden,300,217,218,311,124,183,1353
CC du Haut Pays du Montreuillois,226,193,190,234,119,158,1120
CC du Haut Val d'Oise,749,614,554,575,242,304,3038
CC du Haut Vallespir,281,141,159,160,94,155,990
CC du Haut-Chablais,224,172,194,171,79,58,898
CC du Haut-Jura (Arcade),222,144,152,140,56,80,794
CC du Haut-Poitou,539,451,453,527,306,388,2664
CC du Jovinien,362,289,289,359,193,246,1738
CC du Kochersberg,239,205,209,237,130,137,1157
CC du Kreiz-Breizh (Cckb),277,211,247,252,135,242,1364
CC du Lac d'Aiguebelette (Ccla),89,86,73,69,24,35,376
CC du Lautrécois et du Pays d'Agout,212,187,206,214,119,159,1097
CC du Liancourtois,404,323,345,334,187,268,1861
CC du Limouxin,597,456,386,443,215,378,2475
CC du Massif du Sancy,237,135,137,156,103,117,885
CC du Massif du Vercors,246,167,159,176,96,122,966
CC du Mont des Avaloirs,213,166,154,185,112,164,994
CC du Montbardois,142,153,137,152,78,147,809
CC du Nivernais Bourbonnais,90,64,55,72,44,51,376
CC du Nogentais,287,225,273,257,132,206,1380
CC du Nord Est Béarn,460,372,357,415,202,264,2070
CC du Pays Arnay Liernais,93,71,78,85,42,86,455
CC du Pays Beaume-Drobie,255,136,167,192,91,169,1010
CC du Pays Bellegardien (Ccpb),405,305,390,427,205,204,1936
CC du Pays Bigouden Sud,684,431,441,528,289,423,2796
CC du Pays Châtillonnais,306,228,280,273,170,284,1541
CC du Pays Entre Loire et Rhône,168,147,142,185,81,136,859
CC du Pays Fertois,488,386,429,483,207,261,2254
CC du Pays Fertois et du Bocage Carrougien,86,57,36,62,34,39,314
CC du Pays Fléchois,401,325,375,432,234,404,2171
CC du Pays Fouesnantais,449,372,336,414,188,242,2001
CC du Pays Foyen,342,254,316,369,192,253,1726
CC du Pays Gentiane,84,35,31,55,18,54,277
CC du Pays Grenadois,114,101,99,115,49,81,559
CC du Pays Haut Val d'Alzette,409,319,344,398,213,316,1999
"CC du Pays Houdanais (C,C,P,H,)",329,274,296,316,150,176,1541
CC du Pays Loudunais,536,322,370,448,253,420,2349
CC du Pays Morcenais,173,134,111,137,81,116,752
CC du Pays Mornantais (Copamo),309,253,238,304,112,157,1373
CC du Pays Noyonnais,731,585,648,688,334,620,3606
CC du Pays Orne Moselle,1120,830,823,966,520,720,4979
CC du Pays Rhénan,444,331,389,462,232,373,2231
CC du Pays Ribéracois,319,215,226,266,139,278,1443
CC du Pays Rignacois,76,50,41,62,27,40,296
CC du Pays Riolais,149,137,126,162,87,82,743
CC du Pays Rochois,485,310,263,280,136,144,1618
CC du Pays Roussillonnais,1127,792,681,782,307,346,4035
CC du Pays Réthelois,491,340,451,440,231,283,2236
CC du Pays Solesmois,277,213,231,226,157,272,1376
CC du Pays Tarusate,296,223,235,260,152,208,1374
CC du Pays Viganais,259,155,194,193,99,165,1065
CC du Pays d'Alésia et de la Seine,95,83,80,107,61,81,507
CC du Pays d'Ancenis,986,851,860,889,466,667,4719
CC du Pays d'Etain,129,97,68,115,47,97,553
CC du Pays d'Iroise,600,462,466,560,291,378,2757
CC du Pays d'Issoudun,361,288,325,360,217,344,1895
CC du Pays d'Olmes,414,207,232,285,165,286,1589
CC du Pays d'Oloron et des Vallées du Haut Béarn,761,401,429,449,226,366,2632
CC du Pays d'Othe Aixois,160,112,104,111,56,102,645
CC du Pays d'Urfé,55,46,47,61,34,46,289
CC du Pays d'Uzerche,105,98,79,105,52,84,523
CC du Pays d'huriel,90,79,89,116,48,126,548
CC du Pays d'héricourt,345,312,290,315,190,269,1721
CC du Pays de Barr,373,254,292,346,152,223,1640
CC du Pays de Bitche,512,404,359,418,233,418,2344
CC du Pays de Bray,253,217,273,286,181,278,1488
CC du Pays de Bâgé et de Pont-De-Vaux,312,239,294,305,153,195,1498
"CC du Pays de Chalindrey, de Vannier Amance et de la Région de Bourbonne-Les-Bains",232,144,191,214,106,154,1041
CC du Pays de Château-Gontier,403,330,399,430,238,308,2108
CC du Pays de Châteaugiron,297,271,263,317,136,170,1454
CC du Pays de Colombey et du Sud Toulois,149,137,119,137,72,109,723
CC du Pays de Conches,271,258,254,309,196,286,1574
CC du Pays de Craon,377,334,315,354,156,242,1778
CC du Pays de Cruseilles,224,153,168,154,58,57,814
CC du Pays de Dol et de la Baie du Mont Saint-Michel,394,297,283,373,186,253,1786
CC du Pays de Duras,75,73,73,81,44,61,407
CC du Pays de Falaise,525,341,369,425,213,281,2154
CC du Pays de Fayence,590,388,376,383,187,228,2152
CC du Pays de Fénelon,211,108,131,160,69,109,788
CC du Pays de Gex,1354,981,1083,1149,414,349,5330
CC du Pays de Honfleur-Beuzeville,688,414,403,536,287,324,2652
CC du Pays de Lalbenque-Limogne,125,90,90,125,56,107,593
CC du Pays de Lamastre,85,67,81,113,53,92,491
CC du Pays de Landerneau-Daoulas,713,605,586,743,415,497,3559
CC du Pays de Landivisiau,510,475,437,555,341,399,2717
CC du Pays de Lanouaille,180,139,141,152,70,113,795
CC du Pays de Lapalisse,127,90,120,142,71,139,689
CC du Pays de Lauzun,161,100,129,147,75,111,723
CC du Pays de Limours (Ccpl),248,193,192,195,84,107,1019
CC du Pays de Loiron,206,155,182,209,106,107,965
CC du Pays de Lubersac-Pompadour,90,95,87,111,46,78,507
CC du Pays de Lumbres,349,290,280,335,179,326,1759
CC du Pays de Lunel,1313,1024,1078,1189,652,932,6188
CC du Pays de Lure,330,343,353,333,175,357,1891
CC du Pays de Luxeuil,310,250,245,237,112,224,1378
CC du Pays de Mauriac,89,73,57,68,42,43,372
CC du Pays de Maîche,310,245,225,293,153,118,1344
CC du Pays de Meslay-Grez,210,153,167,172,91,118,911
CC du Pays de Mirepoix,243,149,180,168,101,140,981
CC du Pays de Montbozon et du Chanois,74,66,78,71,32,56,377
CC du Pays de Montfaucon,95,69,77,102,39,101,483
CC du Pays de Montmédy,98,80,69,85,46,70,448
CC du Pays de Mormal,785,613,617,703,353,558,3629
CC du Pays de Mortagne,396,341,321,324,191,266,1839
CC du Pays de Niederbronn-Les-Bains,379,285,287,324,190,275,1740
CC du Pays de Phalsbourg,276,198,187,236,90,136,1123
CC du Pays de Pierrefontaine - Vercel,315,235,286,242,104,107,1289
CC du Pays de Pontchâteau St Gildas des Bois,534,478,493,519,284,451,2759
CC du Pays de Pouzauges,346,243,217,275,159,180,1420
CC du Pays de Redon,1102,997,991,1131,588,1062,5871
CC du Pays de Revigny Sur Ornain,126,84,79,110,48,110,557
CC du Pays de Ribeauvillé,284,190,208,209,112,147,1150
"CC du Pays de Rouffach, Vignobles et Châteaux",129,116,123,153,76,80,677
CC du Pays de Saint Aulaye,96,79,64,97,49,82,467
CC du Pays de Saint Yrieix,128,146,139,177,104,184,878
CC du Pays de Saint-Eloy,219,175,185,169,111,175,1034
CC du Pays de Saint-Fulgent - les Essarts,360,343,308,292,179,234,1716
CC du Pays de Sainte-Odile,257,228,258,281,139,193,1356
CC du Pays de Salars,79,69,64,65,30,39,346
CC du Pays de Salers,121,66,81,77,30,52,427
CC du Pays de Sancey-Belleherbe,74,39,55,52,19,41,280
CC du Pays de Serres en Quercy,165,94,127,136,82,98,702
CC du Pays de Sommières,437,326,370,443,225,369,2170
CC du Pays de St Gilles-Croix-De-Vie,975,746,638,787,473,650,4269
CC du Pays de Stenay et du Val Dunois,152,131,124,127,79,145,758
CC du Pays de Tarascon,228,108,117,125,83,86,747
CC du Pays de Thelle et Ruraloise,859,765,759,842,412,570,4207
CC du Pays de Trie et du Magnoac,70,65,63,70,36,64,368
CC du Pays de Tronçais,100,84,68,107,61,112,532
CC du Pays de Valois,770,677,743,888,457,602,4137
CC du Pays de Villeneuve en Armagnac Landais,105,65,97,80,42,75,464
CC du Pays de Villersexel,106,100,83,117,76,101,583
CC du Pays de Wissembourg,270,166,186,213,113,179,1127
CC du Pays de l'Arbresle (Ccpa),489,398,380,435,234,288,2224
CC du Pays de l'Ourcq,269,245,232,252,122,176,1296
CC du Pays de l'Ozon,327,255,237,251,117,158,1345
CC du Pays de l'huisne Sarthoise,482,416,371,403,244,412,2328
CC du Pays de la Châtaigneraie,208,171,164,208,119,187,1057
CC du Pays de la Serre,206,188,238,306,181,360,1479
CC du Pays de la Zorn,177,147,139,125,80,115,783
CC du Pays des Abers,552,469,484,589,248,408,2750
CC du Pays des Achards,252,217,228,265,150,189,1301
CC du Pays des Ecrins,132,99,116,142,58,54,601
CC du Pays des Herbiers,490,366,376,431,232,345,2240
CC du Pays des Lacs,105,75,66,87,37,30,400
CC du Pays des Paillons,478,334,314,335,142,189,1792
CC du Pays des Sorgues et des Monts de Vaucluse,717,496,603,687,328,475,3306
CC du Pays des Sources,329,265,308,350,156,303,1711
CC du Pays des Trois Rivières,439,324,386,415,218,472,2254
CC du Pays du Coquelicot,414,350,402,489,233,482,2370
CC du Pays du Neubourg,209,216,237,283,174,299,1418
CC du Pays du Saintois,172,157,148,175,74,126,852
CC du Pays du Sanon,63,64,61,77,41,72,378
CC du Pays du Vermandois,505,473,540,572,360,670,3120
CC du Perche,321,233,248,284,172,269,1527
CC du Perche et Haut Vendômois,103,110,90,136,74,101,614
CC du Pilat Rhodanien,237,202,209,228,94,163,1133
CC du Pithiverais,568,450,466,584,295,459,2822
CC du Pithiverais-Gâtinais,440,337,382,474,223,388,2244
CC du Piémont Cévenol,441,322,350,402,201,331,2047
CC du Plateau Picard,545,396,432,467,211,371,2422
CC du Plateau d'hauteville,48,45,68,66,26,39,292
CC du Plateau de Frasne et du Val de Drugeon (Cfd),92,74,86,64,44,21,381
CC du Plateau de Lannemezan,345,197,216,255,108,222,1343
CC du Plateau de Montbazens,70,66,59,61,30,32,318
CC du Plateau de Russey,109,69,92,76,31,32,409
CC du Pont du Gard,514,399,445,515,246,324,2443
CC du Provinois,633,478,464,497,241,386,2699
CC du Périgord Nontronnais,250,149,160,190,108,133,990
CC du Quercy Blanc,122,67,87,100,48,94,518
CC du Quercy Caussadais,399,337,337,381,201,263,1918
CC du Quercy Rouergue et des Gorges de l'Aveyron,130,92,127,124,75,88,636
CC du Rhône Aux Gorges de l'Ardèche,459,334,359,400,185,363,2100
CC du Ried de Marckolsheim,324,232,270,308,135,217,1486
CC du Romorantinais et du Monestois,572,455,512,598,336,500,2973
CC du Rouillacais,149,147,120,130,84,152,782
CC du Royans-Vercors,187,125,145,133,82,112,784
CC du Réolais en Sud Gironde,411,353,381,468,247,390,2250
CC du Réquistanais,37,25,43,53,17,22,197
CC du Sammiellois,146,114,117,120,93,161,751
CC du Sartenais Valinco,606,200,169,118,57,47,1197
CC du Saulnois,399,326,336,351,166,294,1872
CC du Saves,142,100,100,112,51,93,598
CC du Secteur de Saint Loubes,443,380,371,402,207,270,2073
CC du Seignanx,504,394,391,504,219,268,2280
CC du Serein,76,55,70,80,39,48,368
CC du Sisteronais-Buëch,538,321,426,445,234,359,2323
CC du Sor et de l'Agout,363,306,334,343,184,290,1820
CC du Sud Avesnois,588,477,533,548,274,600,3020
CC du Sud Corse,1850,405,265,256,76,52,2904
CC du Sud Est du Pays Manceau,202,190,166,216,109,179,1062
CC du Sud Estuaire,525,390,404,497,258,375,2449
CC du Sud Gironde,783,627,737,798,367,685,3997
CC du Sud Grésivaudan,639,532,633,717,383,513,3417
CC du Sud Marnais,116,88,106,120,56,88,574
CC du Sud Messin,191,175,138,205,87,118,914
CC du Sud Territoire,482,386,405,370,189,292,2124
CC du Sud-Artois,391,280,394,404,208,273,1950
CC du Ternois,604,477,464,595,294,446,2880
CC du Terrassonnais en Périgord Noir Thenon Hautefort,431,318,323,378,203,302,1955
CC du Territoire Nord Picardie,510,435,469,665,306,591,2976
CC du Territoire de Beaurepaire,261,202,227,244,123,188,1245
CC du Territoire de Fresnes en Woëvre,96,58,51,65,32,50,352
CC du Territoire de Lunéville À Baccarat,753,566,623,727,414,767,3850
CC du Thouarsais,604,500,523,577,289,465,2958
CC du Triangle Vert,140,164,143,130,61,116,754
CC du Trièves,165,89,127,144,71,94,690
CC du Val D Amboise,533,410,370,534,291,385,2523
CC du Val Marnaysien,166,156,154,188,85,111,860
CC du Val d'Amour,108,102,106,104,61,75,556
CC du Val d'Argent,161,111,162,162,105,143,844
CC du Val d'Ay,79,57,78,84,33,62,393
CC du Val d'Essonne (Ccve),700,535,511,568,264,378,2956
CC du Val d'Ille-Aubigné,409,445,365,458,241,287,2205
CC du Val d'Orne,58,60,66,69,29,48,330
CC du Val de Bouzanne,79,55,87,84,38,83,426
CC du Val de Cher,67,66,59,63,47,100,402
CC du Val de Drôme,659,506,441,465,280,399,2750
CC du Val de Morteau,399,301,365,304,108,132,1609
CC du Val de Sarthe,355,299,286,387,197,331,1855
CC du Val de Somme,337,277,302,419,183,401,1919
CC du Val de Sully,383,295,358,379,245,314,1974
CC du Val de Vienne,169,142,141,188,94,135,869
CC du Val de l'Aisne,268,252,309,336,179,391,1735
CC du Val de l'Eyre,319,300,302,340,194,227,1682
CC du Val de l'Oise,223,230,244,267,157,369,1490
CC du Vallespir,551,327,335,431,221,339,2204
CC du Vexin Normand,541,507,475,552,261,465,2801
CC du Vexin-Thelle,260,231,260,285,141,177,1354
CC du Vexin-Val de Seine,249,201,196,277,106,173,1202
CC du Vimeu,376,292,342,418,239,394,2061
CC du Volvestre,455,385,431,508,245,487,2511
CC du Warndt,400,308,321,330,178,336,1873
CC l'Orée de la Brie,342,304,296,286,125,135,1488
CC la Clayette Chauffailles en Brionnais,180,151,204,198,110,173,1016
CC la Domitienne,614,492,444,519,255,377,2701
CC la Grandvallière,83,71,68,74,25,32,353
CC la Rochefoucauld - Porte du Périgord,316,276,263,305,163,291,1614
CC la Septaine,140,110,105,164,85,121,725
CC le Dourdannais en Hurepoix (Ccdh),394,262,268,311,129,169,1533
CC le Dunois,92,69,79,121,54,76,491
CC le Gesnois Bilurien,386,380,404,476,225,379,2250
CC le Grand Charolais,577,456,464,557,281,492,2827
CC le Grésivaudan,1384,1070,1076,1237,558,678,6003
CC le Tonnerrois en Bourgogne,272,203,223,242,114,154,1208
CC les Avant-Monts,531,403,407,496,291,384,2512
CC les Balcons du Dauphiné,1200,964,949,1079,510,586,5288
CC les Portes Briardes Entre Villes et Forêts,601,505,570,562,246,361,2845
CC les Portes de l'Ile de France,304,262,287,354,148,245,1600
CC les Trois Provinces,103,57,51,69,38,82,400
CC les Vals du Dauphiné,1071,862,798,996,411,508,4646
CC les Versants d'Aime,197,101,163,116,46,27,650
CC les Villages de la Forêt,64,57,53,73,31,66,344
CU Angers Loire Métropole,5888,4918,4745,5407,2955,5191,29104
CU Caen la Mer,6063,4245,4403,4958,2406,3729,25804
CU Clermont Auvergne Métropole,5489,4256,4200,4691,2249,4077,24962
CU Grand Paris Seine et Oise,8367,6294,6620,7074,3097,4846,36298
CU Orléans Métropole,5599,4430,4843,5395,2775,4423,27465
CU Perpignan Méditerranée Métropole,6884,5258,5069,5963,3145,4610,30929
CU Saint-Etienne Métropole,8498,6303,6196,7199,3512,6417,38125
CU Tour(S) Plus,6548,5141,4849,5370,2730,3941,28579
CU d'Alençon,1118,853,733,813,378,534,4429
CU d'Arras,1960,1594,1587,1863,911,1496,9411
CU de Dunkerque,4382,3530,3404,4024,2024,3484,20848
CU du Grand Dijon,4898,3784,3657,4272,2162,3270,22043
CU du Grand Reims,5739,4395,4380,4896,2461,4255,26126
CU le Creusot Montceau-Lès-Mines,1759,1348,1390,1614,840,1513,8464
CU le Mans Métropole,4730,3857,3690,4185,2311,3681,22454
Eurométropole de Strasbourg,10308,8073,8549,8971,4352,7275,47528
Montpellier Méditerranée Métropole,12329,9660,9330,9804,4577,7233,52933
Métropole Européenne de Lille,23921,18623,18937,21711,11104,21060,115356
Métropole Grenoble-Alpes-Métropole,8727,6480,6454,6811,3161,4142,35775
Métropole Nice Côte d'Azur,13890,8875,9320,10060,4489,6407,53041
Métropole Rouen Normandie,10146,7991,8016,9397,4898,8853,49301
Métropole d'Aix-Marseille-Provence,41113,32080,34003,34973,16637,26571,185377
Métropole de LYON,29029,21656,21811,23590,10871,16077,123034
Métropole du Grand Nancy,4887,3838,3635,4073,2030,3564,22027
Métropole du Grand Paris,137109,99290,105591,112209,52868,102938,610005
Nantes Métropole,12887,10604,10332,11470,5609,8959,59861
Rennes Métropole,8285,7012,6543,7308,3384,5179,37711
Toulouse Métropole,20144,15134,14277,15253,7237,11556,83601
Hors EPCI,6287,5082,6768,9530,4956,8508,41131
