lib_epci,anc_moins_3_mois,anc_3_a_5_mois,anc_6_a_11_mois,anc_12_a_23_mois,anc_24_a_35_mois,anc_plus_36_mois,total
Bordeaux Métropole,18116,14576,14914,16314,7010,11046,81976
Brest Métropole,4065,3234,3109,3610,1753,2956,18727
CA Agglo Pays d'Issoire,970,739,848,1054,466,882,4959
CA Agglo du Pays de Dreux,2228,1666,2035,2249,1091,1955,11224
CA Agglomération du Choletais,1728,1412,1561,1764,856,1558,8879
CA Alès Agglomération,2784,2209,2430,2996,1301,2756,14476
CA Amiens Métropole,4224,3100,3465,3889,1912,3435,20025
CA Annemasse- les Voirons-Agglomération,2210,1586,1766,1859,602,777,8800
CA Annonay Rhône Agglo,833,674,814,963,399,731,4414
CA Ardenne Métropole,2226,1818,2103,2702,1307,2684,12840
CA Arlysère,1203,695,709,657,276,387,3927
CA Bassin d'Arcachon Sud-Pôle Atlantique (Cobas),1448,927,1038,1276,559,926,6174
"CA Beaune, Côte et Sud - Communauté Beaune-Chagny-Nolay",835,615,672,796,385,618,3921
CA Bergeracoise,1163,963,1042,1145,517,972,5802
CA Bourges Plus,1762,1413,1477,1794,923,1555,8924
CA Cannes Pays de Lérins,4898,2815,3035,3836,1555,2481,18620
CA Cap Excellence,2432,2069,2764,3317,1684,5023,17289
CA Carcassonne Agglo,2583,1734,1906,2405,1049,1973,11650
CA Caux Vallée de Seine,1191,1033,1303,1462,754,1461,7204
CA Chambéry Métropole-Coeur des Bauges,2540,1834,1885,2041,832,1172,10304
CA Chartres Métropole,2137,1685,2049,2256,1025,1696,10848
CA Chauny Tergnier la Fère,1062,985,1080,1210,637,1177,6151
CA Châteauroux Métropole,1420,1221,1304,1469,703,1231,7348
CA Civis (Communauté Intercommunale des Villes Solidaires),5259,5134,5859,7058,3844,9917,37071
CA Clisson Sèvre et Maine Agglo,772,611,633,763,346,607,3732
CA Coeur d'Essonne Agglomération,3302,2469,2515,2636,1046,1470,13438
CA Colmar Agglomération,1933,1429,1728,2018,913,1484,9505
CA Communauté Paris-Saclay,4445,3503,3607,3798,1505,2075,18933
CA Concarneau Cornouaille Agglomération,1022,638,731,898,413,645,4347
CA Creil Sud Oise,2192,1622,1893,2134,942,1495,10278
CA Dinan Agglomération,1619,1286,1486,1717,816,1390,8314
CA Dracénoise,2371,1692,1706,2201,859,1301,10130
CA Durance-Lubéron-Verdon Agglomération,1549,1029,1184,1345,676,947,6730
CA Ecla (Espace Communautaire Lons Agglomération),665,430,410,499,224,245,2473
"CA Epernay, Coteaux et Plaine de Champagne",886,660,736,898,398,664,4242
CA Etampois Sud Essonne,911,717,745,715,313,459,3860
CA Evreux Portes de Normandie,2001,1592,1904,2100,1007,1726,10330
CA Flers Agglo,900,702,779,967,469,795,4612
CA Fougères Agglomération,848,737,711,818,374,619,4107
CA Fécamp Caux Littoral Agglomération,708,607,693,787,370,588,3753
CA Gap-Tallard-Durance,920,712,749,894,408,546,4229
CA Golfe du Morbihan - Vannes Agglomération,3066,2412,2447,2788,1302,1919,13934
CA Grand Auch Coeur de Gascogne,716,559,535,561,226,362,2959
CA Grand Belfort,1941,1464,1554,1901,830,1371,9061
CA Grand Lac- Communauté d'Agglomération du Lac du Bourget,1430,914,1003,1103,440,545,5435
CA Grand Montauban,1801,1336,1710,1797,841,1103,8588
CA Grand Paris Sud Seine Essonne Sénart,7176,5206,5937,6043,2401,3294,30057
CA Grand Sud Caraïbe,1910,1551,2089,2673,1312,4207,13742
CA Grand-Poitiers,3395,2687,2724,2965,1343,2148,15262
CA Guingamp-Paimpol Armor-Argoat Agglomération,1293,944,1063,1317,598,1077,6292
"CA Havraise (Co,D,A,H,)",5074,4063,4918,5379,2580,5148,27162
CA Hermitage-Tournonais-Herbasse-Pays de Saint Félicien,1025,917,931,1111,540,816,5340
CA Hérault-Méditerranée,2623,1658,1663,2209,996,1574,10723
CA Intercommunale de la Réunion Est (Cirest),3476,3269,3666,4416,2356,4875,22058
CA Intercommunale du Nord de la Réunion (Cinor),5639,5018,5802,6861,3267,7230,33817
CA Lannion-Trégor Communauté,1729,1237,1310,1563,738,1227,7804
CA Limoges Métropole,3641,3013,3026,3263,1684,2985,17612
CA Lisieux Normandie,1371,989,1108,1121,555,846,5990
CA Loire Forez,1568,1275,1446,1626,688,1059,7662
CA Lorient Agglomération,3858,3014,3291,3542,1736,3089,18530
CA Luberon Monts de Vaucluse,1418,991,1088,1385,662,1049,6593
CA Marne et Gondoire,1509,1220,1312,1335,570,792,6738
CA Maubeuge Val de Sambre,3139,2572,3122,3243,1481,2997,16554
CA Mauges Communauté,1593,1434,1405,1718,833,1355,8338
CA Melun Val de Seine,2707,1997,2405,2397,951,1326,11783
CA Metz Métropole,4378,3456,3979,4562,1825,3392,21592
CA Mont de Marsan Agglomération,985,828,854,883,401,588,4539
CA Mont-Saint-Michel-Normandie,1282,1000,914,1124,497,834,5651
"CA Montargoise et Rives du Loing (A,M,E,)",1426,1104,1177,1362,671,1245,6985
CA Montluçon Communauté,1071,888,997,1242,565,1279,6042
CA Montélimar Agglomération,1538,1129,1240,1374,666,928,6875
CA Morlaix Communauté,1098,874,954,1125,569,887,5507
CA Moulins Communauté,999,797,943,1130,500,1019,5388
CA Mulhouse Alsace Agglomération,5614,4393,5125,5995,2478,3934,27539
CA Mâconnais Beaujolais Agglomération,1468,1191,1344,1420,603,949,6975
CA Paris - Vallée de la Marne,3987,3117,3370,3403,1486,2109,17472
CA Pau Béarn Pyrénées,3103,2521,2789,2981,1250,2053,14697
CA Pays Foix-Varilhes,660,468,596,603,237,391,2955
CA Pays de Montbéliard Agglomération,2642,2027,2198,2633,1115,2193,12808
CA Plaine Vallée,3018,2254,2608,2686,1009,1645,13220
CA Pornic Agglo Pays de Retz,972,793,754,937,464,693,4613
"CA Porte de l'Isère (C,A,P,I)",2277,1839,1993,2081,927,1127,10244
CA Portes de France-Thionville,1350,1023,1288,1348,623,893,6525
CA Privas Centre Ardèche,846,654,684,814,392,512,3902
CA Provence-Alpes-Agglomération,1079,702,822,970,481,723,4777
CA Quimper Bretagne Occidentale,1884,1525,1617,1707,843,1415,8991
CA Rambouillet Territoires,897,703,722,851,347,509,4029
CA Roannais Agglomération,1846,1249,1504,1792,887,1514,8792
CA Rochefort Océan,1296,1102,1088,1274,616,1080,6456
CA Rodez Agglomération,825,736,686,814,322,488,3871
CA Roissy Pays de France,7472,5827,6591,7269,2690,4127,33976
CA Royan Atlantique,1962,1239,1255,1522,717,1010,7705
CA Saint Germain Boucles de Seine,4490,3445,3944,4406,1852,2910,21047
CA Saint-Brieuc Armor Agglomération,2783,2185,2401,2634,1215,2229,13447
CA Saint-Louis Agglomération,1263,895,1134,1307,566,634,5799
CA Saint-Lô Agglo,1144,987,978,1075,563,754,5501
CA Sarreguemines Confluences,1051,833,994,1244,548,926,5596
CA Saumur Val de Loire,1991,1535,1624,1983,968,2135,10236
CA Seine Eure,1314,1018,1194,1436,723,1318,7003
CA Seine Normandie Agglomération,1507,1162,1377,1524,651,1273,7494
CA Sud Sainte Baume,1228,873,782,1024,399,659,4965
CA Tarbes-Lourdes-Pyrénées,4131,1929,2134,2379,1006,1798,13377
CA Terre de Provence,1328,908,966,1235,484,775,5696
CA Territoire de la Côte Ouest (Tco),5924,5660,6538,8716,4811,10573,42222
CA Territoires Vendômois,877,674,700,911,441,769,4372
CA Thonon Agglomération,1766,1140,1166,1316,496,602,6486
CA Toulon Provence Méditerranée,9139,6638,6808,7928,3626,5323,39462
CA Troyes Champagne Métropole,3741,2865,3349,3995,1781,2880,18611
CA Tulle Agglo,695,529,549,621,272,458,3124
CA Val Parisis,4202,3405,3610,4125,1676,2782,19800
CA Val d'Europe Agglomération,482,372,425,433,183,257,2152
CA Val d'Yerres Val de Seine,2816,2199,2404,2539,982,1475,12415
CA Val de Garonne Agglomération,1207,870,933,1062,530,931,5533
CA Valence Romans Agglo,4611,3576,4023,4525,2089,3445,22269
CA Valenciennes Métropole,4340,3639,4051,4469,1953,3660,22112
CA Var Esterel Méditerranée (Cavem),3147,1881,1909,2495,889,1263,11584
CA Ventoux-Comtat-Venaissin (Cove),1735,1270,1382,1580,716,1279,7962
"CA Versailles Grand Parc (C,A,V,G,P,)",2959,2423,2554,2754,1105,1732,13527
CA Vichy Communauté,1421,1096,1252,1495,743,1566,7573
CA Viennagglo,1284,1046,1052,1137,455,623,5597
CA Villefranche Beaujolais Saône,1418,1115,1261,1259,587,880,6520
CA Vitré Communauté,1157,1035,1008,1218,550,746,5714
CA d'Agen,1845,1456,1599,1739,766,1259,8664
CA d'Arles-Crau-Camargue-Montagnette,2582,1618,1815,2241,918,1368,10542
CA d'Epinal,1922,1492,1749,1975,902,1733,9773
CA d'hénin-Carvin,2590,2075,2408,2973,1444,2574,14064
CA de Bar-Le-Duc - Sud Meuse,497,385,544,603,305,505,2839
CA de Bastia,1200,577,591,609,265,322,3564
CA de Blois ''agglopolys'',2157,1553,1619,1871,913,1479,9592
"CA de Béthune-Bruay, Artois-Lys Romane",4964,3901,4532,5069,2452,4769,25687
CA de Béziers-Méditerranée,3424,2534,2467,3111,1439,2198,15173
CA de Cambrai,1616,1332,1661,1872,843,1700,9024
CA de Castres Mazamet,1619,1237,1408,1467,620,1204,7555
CA de Cergy-Pontoise,4312,3265,3632,3979,1612,2437,19237
"CA de Chaumont, du Bassin Nogentais et du Bassin de Bologne Vignory Froncles",704,540,665,660,234,447,3250
CA de Châlons-En-Champagne,1340,1054,1276,1456,587,992,6705
CA de Forbach Porte de France,1559,1154,1416,1789,673,1366,7957
CA de Haguenau,1421,1029,1187,1511,745,1199,7092
CA de Laval,1674,1297,1287,1441,685,1043,7427
CA de Lens - Liévin,4944,3773,4445,5210,2552,5094,26018
CA de Longwy,945,707,916,1087,494,836,4985
CA de Nevers,1146,817,858,1012,408,682,4923
CA de Nîmes Métropole,6272,4916,4911,5900,2532,4644,29175
CA de Saint Quentin en Yvelines,3700,2942,3177,3548,1378,1832,16577
CA de Saint-Dizier Der et Blaise,1094,800,984,1180,537,1021,5616
CA de Saint-Dié-Des-Vosges,1225,961,1265,1561,826,1796,7634
CA de Saintes,1046,928,1014,1093,501,845,5427
CA de Sophia Antipolis,4359,2619,2659,3325,1451,2079,16492
CA de Vesoul,545,513,524,566,225,385,2758
CA de l'Albigeois (C2a),1615,1279,1260,1476,626,981,7237
CA de l'Auxerrois,1154,908,952,1087,449,913,5463
CA de l'Espace Sud de la Martinique,2834,2339,2926,3477,1425,3780,16781
CA de l'Ouest Rhodanien,709,614,662,709,356,559,3609
CA de la Baie de Somme,1102,736,899,928,497,923,5085
CA de la Porte du Hainaut,3382,2676,3359,3819,1824,3359,18419
CA de la Presqu'île de Guérande Atlantique (Cap Atlantique),1531,1003,1000,1260,599,833,6226
CA de la Provence Verte,1928,1589,1597,1913,850,1180,9057
CA de la Riviera Française,1869,1006,997,1258,517,682,6329
CA de la Rochelle,3617,2791,2856,3135,1475,2474,16348
CA de la Région Dieppoise,928,813,874,1013,499,1016,5143
CA de la Région Nazairienne et de l'Estuaire (Carene),2629,1909,2200,2436,1109,1986,12269
CA de la Région de Château-Thierry,1026,873,1018,1054,536,960,5467
CA de la Région de Compiègne et de la Basse Automne,1493,1138,1382,1622,747,1153,7535
CA des Deux Baies en Montreuillois,1327,902,943,1147,539,1030,5888
CA du Bassin d'Aurillac,732,565,601,693,329,512,3432
CA du Bassin de Bourg-En-Bresse,2099,1672,1826,1871,921,1158,9547
CA du Bassin de Brive,1885,1451,1547,1815,895,1447,9040
CA du Bassin de Thau,3141,2191,2386,2906,1364,2379,14367
CA du Beauvaisis,2103,1589,1799,2153,884,1613,10141
CA du Bocage Bressuirais,1105,927,999,1176,593,829,5629
CA du Boulonnais,2444,2005,2180,2607,1306,2302,12844
CA du Calaisis,2155,1786,2001,2568,1193,2411,12114
CA du Centre Littoral,3357,3097,3095,2728,1005,1557,14839
CA du Centre de la Martinique,3598,3119,3809,4284,1954,4908,21672
CA du Cotentin,2152,1708,1641,1930,936,1520,9887
"CA du Douaisis [c,A,D,]",3364,2690,3223,3602,1663,3407,17949
CA du Gard Rhodanien,1489,1189,1245,1457,691,1074,7145
CA du Grand Angoulême,2590,2374,2544,2913,1249,2391,14061
CA du Grand Annecy,3451,2447,2393,1824,705,811,11631
CA du Grand Avignon (Coga),4978,3772,3950,4458,2000,3304,22462
CA du Grand Besançon,3576,2730,2853,3386,1408,2127,16080
CA du Grand Cahors,859,668,673,852,376,655,4083
CA du Grand Cognac,1176,989,1116,1298,628,978,6185
CA du Grand Dax,1356,932,1002,1169,553,791,5803
CA du Grand Dole,889,694,765,822,369,590,4129
CA du Grand Guéret,472,397,418,407,179,361,2234
CA du Grand Sénonais,1132,850,967,1186,494,856,5485
CA du Grand Verdun,492,376,443,511,237,375,2434
CA du Grand Villeneuvois,1008,758,787,925,486,736,4700
CA du Libournais,1908,1525,1636,2011,925,1567,9572
CA du Niortais,2113,1561,1661,1951,912,1431,9629
CA du Nord Basse-Terre,1793,1505,2008,2421,1081,3034,11842
CA du Nord Grande Terre,1191,1162,1488,1879,1021,3358,10099
CA du Pays Ajaccien,1842,912,931,1018,366,513,5582
CA du Pays Basque,6679,4373,4484,5295,2391,3497,26719
CA du Pays Châtelleraudais,1397,1228,1310,1349,662,1194,7140
CA du Pays Nord Martinique,2557,2057,2562,2912,1178,3470,14736
CA du Pays Voironnais,1429,1112,1255,1303,552,741,6392
CA du Pays de Fontainebleau,946,733,773,826,333,555,4166
CA du Pays de Grasse,2248,1574,1628,1876,756,1023,9105
CA du Pays de Laon,813,755,854,1011,441,1089,4963
CA du Pays de Meaux,1971,1444,1706,1763,700,997,8581
CA du Pays de Quimperlé,926,705,773,898,489,695,4486
CA du Pays de Saint Malo - Saint Malo Agglomération,1784,1141,1312,1431,626,988,7282
CA du Pays de Saint-Omer,1830,1442,1612,2071,952,1880,9787
CA du Pays de l'Or,1293,907,952,1192,486,782,5612
CA du Puy-En-Velay,1327,1026,1104,1266,612,1016,6351
CA du Rabastinois - Tarn et Dadou - Vère Grésigne et Pays Salvagnacois,1423,1091,1278,1492,679,1104,7067
CA du Saint-Quentinois,1682,1477,1581,2037,937,2185,9899
CA du Sicoval,1120,1004,992,1146,508,780,5550
CA du Soissonnais,972,925,1092,1195,667,1328,6179
CA du Sud,3497,3820,3961,5549,2887,7459,27173
CA du Val de Fensch,1362,1061,1162,1532,634,1074,6825
CA la Riviéra du Levant,1612,1383,1758,2143,1096,3028,11020
CA la Roche Sur Yon - Agglomération,1783,1557,1543,1796,764,1411,8854
CA le Grand Chalon,1978,1609,1768,2008,1058,1689,10110
CA le Grand Narbonne,3290,2397,2350,3017,1383,2534,14971
CA le Grand Périgueux,1962,1494,1615,1723,821,1297,8912
CA le Muretain Agglo,2030,1760,1859,2172,1000,1604,10425
CA les Sables d'Olonne Agglomération,1018,721,742,861,448,806,4596
CC Adour Madiran,424,338,319,358,148,270,1857
CC Agglo Saint-Avold Centre Mosellan,982,741,933,1000,473,826,4955
CC Agly Fenouillèdes,109,94,95,152,69,141,660
CC Airvaudais-Val du Thouet,83,72,93,100,61,101,510
CC Albret Communauté,410,363,415,462,238,440,2328
CC Alpes d'Azur,149,123,131,160,75,95,733
"CC Alpes-Provence-Verdon ""sources de Lumière""",286,149,127,225,96,172,1055
CC Altitude 800,77,45,54,65,30,36,307
CC Ambert Livradois Forez,357,282,344,432,190,387,1992
CC Amognes Coeur du Nivernais,99,74,101,108,49,77,508
CC Andaine - Passais,217,110,146,176,87,107,843
CC Anjou Bleu Communauté,657,530,471,397,196,306,2557
CC Anjou Loir et Sarthe,432,354,356,463,231,485,2321
"CC Arbois, Poligny, Salins, Coeur du Jura",280,195,250,258,130,185,1298
CC Arc Sud Bretagne,440,357,368,432,230,313,2140
"CC Ardenne, Rives de Meuse",540,373,458,636,288,487,2782
CC Ardennes Thiérache,140,103,125,172,58,145,743
CC Ardèche Rhône Coiron,465,362,458,450,238,339,2312
CC Ardèche des Sources et Volcans,201,117,170,226,104,175,993
CC Argentan Intercom,517,418,468,469,227,345,2444
CC Argonne-Meuse,101,62,84,78,42,81,448
CC Arize Lèze,211,160,178,203,85,160,997
CC Armagnac Adour,91,68,88,106,51,59,463
CC Arnon Boischaut Cher,121,84,102,143,63,120,633
CC Artagnan de Fezensac,100,84,79,77,33,61,434
CC Arve et Salève,317,230,253,257,81,71,1209
CC Astarac Arros en Gascogne,96,71,95,97,38,60,457
CC Au Pays de la Roche Aux Fées,321,310,295,362,205,281,1774
CC Aubrac Lot Causse et Pays de Chanac,136,83,79,86,38,42,464
CC Aubrac et Carladez,94,59,53,76,36,54,372
CC Aunis Atlantique,496,423,411,509,221,344,2404
CC Aunis Sud,556,455,493,544,258,441,2747
CC Auray Quiberon Terre Atlantique,1912,1239,1279,1555,775,1196,7956
CC Aure Louron,161,111,131,160,83,106,752
CC Auxonne Pontailler Val de Saône,300,290,304,418,232,303,1847
CC Auzon Communauté,163,125,190,163,63,159,863
"CC Avallon, Vézelay, Morvan",332,231,241,315,124,160,1403
CC Aveyron Ségala Viaur,69,45,63,90,36,39,342
CC Avre Luce Noye,324,227,328,379,176,300,1734
CC Aygues-Ouvèze en Provence (Ccaop),344,309,282,400,160,236,1731
CC Bassée-Montois,330,249,270,280,122,218,1469
CC Bastides de Lomagne,123,106,113,142,70,106,660
CC Bastides et Vallons du Gers,92,82,89,89,49,81,482
CC Baugeois Vallée,527,410,479,542,260,563,2781
CC Bazois Loire Morvan,163,146,149,218,102,188,966
CC Beaucaire Terre d'Argence,984,723,733,932,432,655,4459
CC Beauce Val de Loire,300,215,235,314,144,275,1483
CC Beaujolais Pierres Dorées,612,488,499,513,232,314,2658
CC Berg et Coiron,165,104,127,157,60,131,744
CC Berry Grand Sud,158,120,159,207,80,190,914
CC Berry Loire Puisaye,283,235,268,334,176,364,1660
CC Berry-Loire-Vauvise,58,70,64,102,52,83,429
CC Billom Communauté,336,302,331,380,174,333,1856
CC Bièvre Isère,828,674,759,841,400,515,4017
CC Blangy-Pont l'Evêque Intercom,258,191,196,239,100,136,1120
CC Bouzonvillois-Trois Frontières,282,268,276,317,136,264,1543
CC Brenne - Val de Creuse,218,203,229,242,137,153,1182
CC Bresse Haute Seille,257,200,181,240,105,130,1113
CC Bresse Louhannaise Intercom',437,339,373,391,170,230,1940
CC Bresse Revermont 71,154,105,100,129,59,88,635
CC Bretagne Porte de Loire Communauté,435,366,404,457,213,329,2204
CC Bretagne Romantique,524,412,454,536,261,436,2623
CC Briance Combade,66,53,69,84,32,77,381
CC Briance Sud Haute Vienne,93,76,106,123,64,115,577
CC Brie Nangissienne,402,322,357,383,150,239,1853
CC Brie des Rivières et Châteaux,398,335,396,438,151,225,1943
CC Bruyères-Vallons des Vosges,229,186,199,245,127,293,1279
CC Bugey Sud,561,444,484,572,239,347,2647
CC Buëch-Dévoluy,140,130,132,167,80,133,782
CC Cagire Garonne Salat,258,219,258,247,139,280,1401
CC Campagne-De-Caux,176,171,170,224,115,169,1025
CC Canaux et Forêts en Gâtinais,386,314,337,404,254,448,2143
CC Cap Sizun - Pointe du Raz,248,151,180,183,114,191,1067
CC Capcir Haut Conflent,138,75,114,174,71,96,668
CC Carmausin-Ségala,576,436,508,556,252,406,2734
CC Carnelle Pays-De-France,369,291,315,360,118,220,1673
CC Castelnaudary Lauragais Audois,533,443,414,452,210,344,2396
CC Castillon/Pujols,419,364,341,444,205,308,2081
CC Causses Aigoual Cévennes,122,93,100,109,48,92,564
CC Causses et Vallée de la Dordogne,852,569,642,784,357,595,3799
CC Caux - Austreberthe,384,366,415,435,225,427,2252
CC Caux Estuaire,174,167,228,235,120,206,1130
CC Cazals-Salviac,74,65,76,96,41,64,416
CC Centre Morbihan Communauté,639,524,605,670,377,512,3327
CC Centre Tarn,173,137,157,189,72,137,865
"CC Chablis, Villages et Terroirs",172,151,180,185,90,146,924
CC Chabris - Pays de Bazelle,79,68,80,98,51,82,458
CC Challans-Gois Communauté,808,669,679,809,365,624,3954
CC Chalosse Tursan,369,316,324,395,199,307,1910
CC Champagnole Nozeroy Jura,305,242,263,317,140,147,1414
CC Champsaur-Valgaudemar,154,136,167,218,119,170,964
CC Charente-Arnoult-Coeur de Saintonge,318,217,270,247,137,240,1429
CC Charlieu-Belmont,301,250,272,357,192,297,1669
CC Chavanon Combrailles et Volcans,145,126,106,153,96,132,758
"CC Chinon, Vienne et Loire",417,281,277,375,190,293,1833
CC Châteaubriant-Derval,724,577,586,702,318,630,3537
"CC Chénérailles, Auzances/Bellegarde et Haut Pays Marchois",164,137,163,169,94,168,895
"CC Ciate, Bourganeuf/Royère-De-Vassivière",175,170,183,240,109,220,1097
CC Cingal-Suisse Normande,360,328,332,418,155,285,1878
CC Cluses-Arve et Montagnes,934,745,828,952,342,549,4350
CC Coeur Côte Fleurie,468,287,302,372,167,279,1875
CC Coeur Haute Lande,357,278,307,322,161,245,1670
CC Coeur d'Astarac en Gascogne,120,93,95,122,46,84,560
"CC Coeur d'Ostrevent [c,C,C,O,]",1401,1189,1462,1616,801,1413,7882
CC Coeur d'Yvelines,495,371,421,516,202,278,2283
CC Coeur de Beauce,339,256,330,365,196,264,1750
CC Coeur de Berry,266,182,215,294,133,239,1329
CC Coeur de Brenne,45,41,70,59,34,60,309
CC Coeur de Charente,316,265,329,367,153,314,1744
CC Coeur de Chartreuse,224,193,214,208,91,143,1073
CC Coeur de France,289,222,264,329,174,366,1644
CC Coeur de Garonne,528,440,547,614,296,525,2950
CC Coeur de Lozère,251,186,160,176,80,79,932
CC Coeur de Maurienne Arvan,245,180,249,213,73,110,1070
CC Coeur de Nacre,372,297,295,390,184,288,1826
CC Coeur de Savoie,625,436,475,480,222,310,2548
CC Coeur de Sologne,155,107,135,145,99,148,789
CC Coeur de Tarentaise,287,97,147,74,49,44,698
CC Coeur de l'Avesnois,577,465,533,621,276,605,3077
CC Coeur du Perche,169,136,136,170,87,127,825
CC Coeur du Var,795,718,719,831,349,533,3945
CC Coeur et Coteaux du Comminges,714,593,603,712,338,596,3556
CC Combrailles Sioule et Morge,265,228,233,274,126,219,1345
CC Commentry Montmarault Néris Communauté,390,314,351,380,192,492,2119
CC Communauté Bray-Eawy,344,268,281,388,176,284,1741
CC Communauté Lesneven Côte des Légendes,426,352,331,477,232,347,2165
CC Communauté de Communes de Thann-Cernay,620,486,549,652,259,457,3023
CC Comtal Lot et Truyère,212,173,169,200,92,133,979
CC Conflent-Canigó,554,379,359,513,217,331,2353
CC Conques-Marcillac,135,94,125,145,57,94,650
CC Corbières Salanque Méditerranée,455,343,374,463,211,370,2216
CC Coteaux et Plaines du Pays Lafrançaisain,172,166,175,195,95,157,960
CC Coteaux et Vallées des Luys,128,66,100,144,38,76,552
CC Couesnon Marches de Bretagne,286,221,250,273,136,222,1388
CC Couserans-Pyrénées,715,477,618,639,269,490,3208
CC Coutances Mer et Bocage,706,549,622,702,345,490,3414
CC Creuse Grand Sud,191,176,199,207,101,240,1114
CC Cère et Goul en Carladès,42,40,49,55,39,50,275
CC Côte Landes Nature,368,152,143,240,113,145,1161
CC Côte Ouest Centre Manche,315,240,323,350,176,264,1668
CC Côte d'Albâtre,372,348,399,474,254,451,2298
CC Côte d'Emeraude,608,385,415,500,241,379,2528
CC Côtes de Champagne et Val de Saulx,195,148,176,174,93,130,916
CC Côtes de Meuse Woëvre,105,69,71,100,58,69,472
CC Decazeville Communauté,318,251,275,253,102,181,1380
CC Dieulefit-Bourdeaux,163,138,149,174,79,143,846
CC Dombes Saône Vallée,494,352,399,426,161,182,2014
CC Domfront Tinchebray Interco,215,144,174,230,112,167,1042
CC Douarnenez Communauté,385,277,338,358,191,337,1886
CC Dronne et Belle,185,121,130,138,62,108,744
CC Drôme Sud Provence,831,718,845,936,420,687,4437
CC Dômes Sancy Artense,152,105,127,164,77,112,737
CC Ecueillé-Valençay,156,114,121,182,75,144,792
CC Eguzon - Argenton - Vallée de la Creuse,312,268,256,344,157,279,1616
CC Elan Limousin Avenir Nature,320,297,343,404,185,334,1883
CC Enclave des Papes-Pays de Grignan,452,334,447,468,211,421,2333
CC Entr'allier Besbre et Loire,352,276,313,381,190,429,1941
CC Entre Aire et Meuse - Triaucourt-Vaubécourt,77,54,59,82,27,69,368
"CC Entre Arroux, Loire et Somme",295,245,269,336,146,279,1570
CC Entre Beauce et Perche,268,228,213,302,146,247,1404
CC Entre Dore et Allier,262,222,266,332,174,292,1548
CC Entre Juine et Renarde (Ccejr),302,246,229,267,104,176,1324
CC Entre Saône et Grosne,163,130,106,141,94,140,774
CC Estuaire et Sillon,532,439,455,530,257,375,2588
CC Eure-Madrie-Seine,493,385,438,582,255,465,2618
CC Falaises du Talou,364,298,332,425,201,378,1998
CC Faucigny-Glières,457,374,411,416,143,207,2008
CC Fercher Pays Florentais,187,153,156,184,81,159,920
CC Fier et Usses,224,195,165,190,71,94,939
CC Flandre Lys,567,506,519,607,298,423,2920
"CC Forêts, Lacs, Terres en Champagne",102,65,105,104,60,56,492
"CC Forêts, Seine et Suzon",63,52,70,73,22,52,332
CC Fumel Vallée du Lot,396,298,313,485,221,383,2096
CC Gally Mauldre,183,153,163,213,115,146,973
CC Gartempe - Saint Pardoux,55,61,58,80,36,73,363
CC Giennoises,528,381,434,469,268,475,2555
CC Gorges Causses Cévennes,190,76,88,129,50,49,582
CC Grand Orb Communauté de Communes en Languedoc,433,295,308,391,184,332,1943
CC Grand Sud Tarn et Garonne,772,664,764,811,372,576,3959
CC Grand-Figeac,724,470,503,537,240,328,2802
CC Gâtinais Val de Loing,267,237,245,312,133,213,1407
CC Haut - Bugey,1130,826,1078,1090,511,714,5349
CC Haut Chemin-Pays de Pange,174,173,180,227,92,153,999
CC Haut Limousin en Marche,270,224,231,342,162,291,1520
CC Haut Nivernais-Val d'Yonne,133,133,139,192,76,145,818
CC Haut Val de Sèvre,412,357,385,431,223,387,2195
CC Haut-Jura Saint-Claude,389,259,280,334,153,219,1634
CC Haut-Léon Communauté,526,352,411,492,278,480,2539
CC Haute Maurienne Vanoise,142,96,109,82,33,37,499
CC Haute Sarthe Alpes Mancelles,289,238,298,318,187,331,1661
CC Haute Saulx et Perthois-Val d'Ornois,219,171,200,237,126,236,1189
CC Haute Vallée du Thoré,107,60,82,80,45,61,435
CC Haute-Corrèze Communauté,505,348,338,404,192,288,2075
CC Haute-Provence-Pays de Banon,212,148,172,199,107,156,994
CC Hautes Terres,164,104,110,122,55,73,628
CC Houve-Pays Boulageois,301,249,276,343,159,261,1589
CC Inter-Caux-Vexin,566,460,527,660,277,529,3019
CC Interco Normandie Sud Eure,712,626,654,831,409,729,3961
CC Intercom Bernay Terres de Normandie,815,679,813,906,413,990,4616
CC Intercom de la Vire Au Noireau,738,593,643,690,347,662,3673
CC Interrégionale Aumale - Blangy-Sur-Bresle,307,245,329,381,185,359,1806
CC Isigny-Omaha Intercom,410,264,328,370,223,299,1894
CC Isle Double Landais,195,158,201,220,100,213,1087
CC Isle Vern Salembre en Périgord,306,260,294,286,147,299,1592
CC Isle et Crempse en Périgord,193,166,206,247,101,206,1119
CC Jabron-Lure-Vançon-Durance,80,62,96,93,50,71,452
CC Jalle-Eau-Bourde,382,338,357,416,197,277,1967
CC Jura Nord,145,132,131,164,73,115,760
CC Jura Sud,94,95,104,122,61,78,554
CC Lacs et Gorges du Verdon,232,128,110,164,75,124,833
CC Lamballe Terre et Mer,1055,816,848,947,481,745,4892
CC Larzac et Vallées,101,58,69,88,44,42,402
CC Latitude Nord Gironde,387,330,375,441,205,344,2082
CC Lauragais Revel Sorezois,411,304,346,413,171,321,1966
CC Lavalette Tude Dronne,244,214,229,229,116,214,1246
CC Leff Armor Communauté,524,404,467,528,260,382,2565
CC Lieuvin Pays d'Auge,272,222,277,290,138,268,1467
CC Liffré-Cormier Communauté,311,279,299,307,127,202,1525
CC Loches Sud Touraine,770,657,701,778,348,663,3917
CC Lodévois et Larzac,348,287,293,350,149,272,1699
CC Loir-Lucé-Bercé,370,308,318,396,209,432,2033
CC Loire Layon Aubance,704,642,616,737,395,680,3774
CC Loire et Allier,72,50,62,76,26,56,342
CC Loire et Semène,279,227,233,275,155,217,1386
"CC Loire, Nièvre et Bertranges",261,242,210,290,134,222,1359
"CC Loire, Vignobles et Nohain",307,312,394,395,180,345,1933
CC Lot et Tolzac,126,97,109,118,57,94,601
CC Loudéac Communauté - Bretagne Centre,879,598,768,769,349,505,3868
CC Loue-Lison,293,228,245,340,133,175,1414
CC Loué - Brûlon - Noyen,256,213,262,294,137,206,1368
CC Lyon Saint Exupéry en Dauphiné,450,367,433,508,191,273,2222
CC Lyons Andelle,334,237,299,346,180,369,1765
CC Lèze Ariège,517,462,469,565,259,442,2714
CC Mad et Moselle,244,196,230,280,129,198,1277
CC Maine Coeur de Sarthe,218,207,210,258,149,257,1299
CC Maine Saosnois,426,358,411,464,210,405,2274
CC Maison de l'Intercommunalité de Haute Tarentaise,317,181,354,194,63,70,1179
CC Marche Occitane - Val d'Anglin,88,63,65,83,43,69,411
CC Marches du Velay-Rochebaron,446,365,373,445,205,393,2227
CC Maremne Adour Côte Sud,2035,1113,1131,1440,636,785,7140
CC Maurienne Galibier,92,76,73,66,27,26,360
CC Mayenne Communauté,483,367,368,479,222,322,2241
"CC Meurthe, Mortagne, Moselle",203,179,200,252,125,225,1184
CC Meuse Rognon,140,101,123,129,80,110,683
CC Midi Corrézien,189,129,154,217,77,163,929
CC Minervois Saint-Ponais Orb-Jaur,283,210,203,283,151,260,1390
CC Mirebellois et Fontenois,134,101,126,139,84,114,698
CC Mond'arverne Communauté,470,400,444,519,283,433,2549
CC Mont Lozère,96,47,56,56,31,44,330
CC Montfort Communauté,315,272,268,307,160,242,1564
CC Monts d'Arrée Communauté,110,90,123,140,66,131,660
"CC Monts, Rance et Rougier",71,70,55,89,50,71,406
CC Moret Seine et Loing,527,459,411,490,224,335,2446
CC Morvan Sommets et Grands Lacs,130,101,104,146,75,140,696
CC Moselle et Madon,332,260,335,453,168,254,1802
CC Moutierrois Talmondais,633,469,471,590,321,542,3026
CC Mâconnais - Tournugeois,252,205,257,283,128,184,1309
CC Méditerranée Porte des Maures,1150,634,622,855,420,596,4277
CC Médoc Atlantique,773,438,414,665,344,458,3092
CC Médoc Coeur de Presqu'ile,734,534,559,680,308,510,3325
CC Médoc Estuaire,436,336,356,484,170,295,2077
CC Médullienne,355,311,297,408,162,231,1764
CC Mézenc-Loire-Meygal,126,94,139,144,71,104,678
CC Nebbiu - Conca d'Oro,292,89,75,103,28,38,625
CC Neste Barousse,97,80,86,92,53,76,484
CC Nièvre et Somme,446,374,493,584,367,591,2855
CC Norge et Tille,119,109,121,161,73,109,692
CC Normandie-Cabourg-Pays d'Auge,539,389,387,497,235,331,2378
CC Océan Marais de Monts,488,315,267,373,192,271,1906
CC Orée de Bercé - Belinois,214,242,232,294,160,277,1419
CC Osartis Marquion,573,487,634,747,349,461,3251
CC Ouche et Montagne,103,95,104,139,75,113,629
CC Ouest Limousin,144,100,128,153,100,142,767
CC Pays Créçois,428,354,339,377,197,254,1949
"CC Pays Dunois, Pays Sostranien, Bénévent/Grand-Bourg",320,258,280,316,144,236,1554
CC Pays Forcalquier et Montagne de Lure,253,146,201,223,87,152,1062
CC Pays Fort Sancerrois Val de Loire,233,194,224,236,140,248,1275
CC Pays Rhin - Brisach,398,323,318,403,253,320,2015
CC Pays Ségali,184,146,178,213,84,113,918
CC Pays Vaison Ventoux (Copavo),344,233,235,330,186,237,1565
CC Pays d'Apt-Luberon,797,426,550,580,252,438,3043
CC Pays d'Evian Vallée d'Abondance,881,546,585,568,232,254,3066
CC Pays d'Opale,363,333,388,521,227,511,2343
CC Pays d'Orthe et Arrigans,456,344,347,462,192,332,2133
CC Pays d'Uzès,527,409,438,530,240,415,2559
"CC Pays de Boussac, Carrefour des Quatre Provinces, Evaux-Les-Bains/Chambon-Sur-Voueize",258,191,217,231,137,219,1253
CC Pays de Chantonnay,328,283,298,401,145,274,1729
CC Pays de Coulommiers,738,526,633,637,299,352,3185
CC Pays de Fontenay-Vendée,615,521,604,635,271,574,3220
CC Pays de L?audunois et du Bassin de Landres,331,239,303,373,180,289,1715
CC Pays de Montereau,862,665,682,764,302,488,3763
CC Pays de Nay,340,307,324,390,171,290,1822
CC Pays de Nemours,505,393,429,466,228,331,2352
CC Pays de Nexon Monts de Chalus,146,130,146,149,86,141,798
CC Pays de Nérondes,78,61,59,72,38,79,387
CC Pays des Vans en Cévennes,246,167,180,208,99,187,1087
CC Pays du Mont-Blanc,789,535,575,540,223,225,2887
CC Perthois-Bocage et Der,90,53,64,80,42,61,390
CC Petite Montagne,94,63,69,86,41,40,393
CC Picardie des Châteaux,260,272,266,329,200,325,1652
CC Piège Lauragais Malepère,302,247,224,287,127,197,1384
CC Plaine Limagne,295,255,295,352,169,326,1692
CC Plaines et Monts de France,276,237,215,256,111,161,1256
CC Plateau de Caux-Doudeville-Yerville,235,252,271,314,184,288,1544
CC Pleyben-Châteaulin-Porzay,398,294,314,320,186,294,1806
CC Poher Communauté,236,220,247,230,110,192,1235
CC Ponthieu-Marquenterre,631,364,410,560,284,455,2704
CC Pontivy Communauté,803,558,673,692,340,519,3585
CC Porte Océane du Limousin,379,292,325,359,199,405,1959
CC Porte d'Alsace - Largue,297,227,233,319,139,187,1402
CC Porte d'Aquitaine en Pays de Serres,95,51,70,78,47,52,393
CC Porte de Dromardèche,908,689,821,996,422,646,4482
CC Porte de Maurienne,96,68,97,96,44,49,450
CC Porte du Jura,178,136,110,113,52,55,644
CC Portes de la Creuse en Marche,93,63,90,84,53,93,476
CC Portes du Berry Entre Loire et Val d'Aubois,104,117,115,142,88,174,740
CC Presqu'île de Crozon-Aulne Maritime,392,289,319,410,200,325,1935
CC Provence Verdon,413,307,354,420,202,282,1978
CC Pré-Bocage Intercom,343,285,344,327,161,238,1698
CC Pyrénées Audoises,285,181,221,273,103,245,1308
CC Pyrénées Cerdagne,164,110,131,143,68,71,687
CC Pyrénées Haut Garonnaises,328,167,194,230,119,209,1247
CC Pyrénées Vallées des Gaves,479,193,215,248,117,180,1432
CC Pévèle-Carembault,1149,928,1019,1228,608,1037,5969
CC Quercy - Bouriane,185,116,149,170,90,139,849
CC Quercy Vert-Aveyron,363,312,394,428,184,254,1935
CC Questembert Communauté,365,311,302,413,174,306,1871
CC Rahin et Cherimont,166,141,168,185,82,198,940
CC Randon - Margeride,56,37,48,39,20,21,221
CC Retz en Valois,499,381,489,576,282,593,2820
"CC Rhony, Vistre, Vidourle",577,404,396,524,221,355,2477
CC Rhône Crussol,468,426,439,455,236,354,2378
CC Rhône Lez Provence,566,475,487,626,262,471,2887
CC Riom Limagne et Volcans,922,745,815,972,485,894,4833
CC Rives de Moselle,853,664,803,984,448,727,4479
"CC Rives de Saône, Cc Saint Jean de Losne Seurre",303,224,246,342,142,267,1524
CC Rives de l'Ain - Pays du Cerdon,224,164,214,262,102,135,1101
CC Roi Morvan Communauté,392,282,342,438,207,387,2048
CC Roumois Seine,620,546,636,763,402,652,3619
CC Roussillon-Conflent,424,440,329,444,270,355,2262
CC Rurales de l'Entre-Deux-Mers,271,194,229,313,172,262,1441
"CC Région Lézignanaise, Corbières et Minervois",714,511,559,649,337,516,3286
"CC Saint Affricain, Roquefort, Sept Vallons",205,171,202,216,92,143,1029
CC Saint Cyr Mère Boitier Entre Charolais et Mâconnais,78,82,88,90,50,67,455
CC Saint-Pourçain Sioule Limagne,466,397,453,527,257,477,2577
CC Sarlat-Périgord Noir,539,230,259,299,172,212,1711
CC Sarrebourg Moselle Sud,720,519,628,665,294,444,3270
CC Sauer-Pechelbronn,204,162,157,246,106,179,1054
CC Sauldre et Sologne,217,185,193,211,106,185,1097
CC Sausseron Impressionnistes,237,187,174,262,115,169,1144
CC Save Garonne et Côteaux de Cadours,528,444,491,520,211,333,2527
CC Saône Doubs Bresse,157,139,134,199,112,163,904
CC Saône-Beaujolais,645,475,562,687,271,409,3049
CC Seine et Aube,157,123,134,183,95,150,842
CC Senlis Sud Oise,341,256,290,380,178,224,1669
CC Serein et Armance,409,291,316,456,207,337,2016
CC Serre-Ponçon,371,264,305,387,194,223,1744
CC Serre-Ponçon Val d'Avance,131,109,101,153,71,95,660
CC Seulles Terre et Mer,226,175,152,187,100,141,981
CC Sidobre Val d'Agout-Vals et Plateaux des Monts de Lacaune,184,165,191,201,90,144,975
CC Somme Sud-Ouest,546,458,518,600,315,550,2987
CC Sud Côte Chalonnaise,136,113,116,184,94,138,781
CC Sud Nivernais,282,221,240,307,146,264,1460
CC Sud Retz Atlantique,500,383,448,511,266,387,2495
CC Sud Sarthe,424,394,410,478,290,551,2547
CC Sud Vendée Littoral,1006,756,735,953,475,795,4720
CC Sud-Hérault,323,260,291,373,169,287,1703
CC Sud-Roussillon,603,444,420,601,305,490,2863
CC Sumène - Artense,101,87,77,91,59,59,474
CC Sèvre et Loire,624,552,595,740,324,519,3354
CC Tannay-Brinon-Corbigny,82,82,73,107,68,129,541
CC Tarn-Agout,392,347,421,535,194,332,2221
CC Terre Lorraine du Longuyonnais,211,131,194,197,87,190,1010
CC Terre d'Eau,343,200,246,330,174,351,1644
CC Terre de Camargue,760,411,389,518,289,420,2787
CC Terre de Picardie,330,247,333,348,183,333,1774
CC Terres Touloises,657,556,611,676,294,513,3307
CC Terres de Bresse,319,241,281,354,164,280,1639
CC Terres de Chalosse,346,222,264,330,132,205,1499
"CC Terres de Montaigu, Cc Montaigu-Rocheservière",688,553,549,686,292,465,3233
CC Terres de Perche,264,178,232,266,134,203,1277
CC Terres de Saône,176,141,159,201,68,123,868
CC Terres des Confluences,1245,741,913,1098,440,786,5223
CC Terres du Haut Berry,299,266,261,320,211,297,1654
CC Territoriale Sud-Luberon,485,361,389,472,172,295,2174
CC Terroir de Caux,480,415,453,596,307,478,2729
CC Thiers Dore et Montagne,683,558,724,821,408,785,3979
CC Thiérache Sambre et Oise,266,279,332,427,216,447,1967
CC Tille et Venelle,66,59,58,71,39,59,352
CC Touraine Ouest Val de Loire,546,424,486,554,298,533,2841
CC Touraine Val de Vienne,383,293,370,414,229,350,2039
CC Touraine Vallée de l'Indre,675,567,590,694,337,555,3418
CC Touraine-Est Vallées,488,394,470,510,227,354,2443
CC Usses et Rhône,275,212,253,271,98,114,1223
CC Val 81,76,49,56,78,37,59,355
CC Val Briard,431,351,343,396,161,213,1895
CC Val Eyrieux,152,131,127,186,116,155,867
CC Val Guiers,196,177,153,176,86,109,897
CC Val Vanoise Tarentaise,163,93,148,60,16,29,509
CC Val de Charente,231,190,225,253,107,218,1224
CC Val de Gers,133,81,113,103,53,94,577
CC Val de Gray,339,269,302,399,144,258,1711
CC Val de Gâtine,252,246,267,342,155,247,1509
CC Val de Ligne,158,115,112,134,65,141,725
CC Val de Meuse - Voie Sacrée,99,95,101,130,50,109,584
CC Val de Saône Centre,261,188,228,253,105,103,1138
CC Val de l'Indre - Brenne,169,167,177,235,101,175,1024
CC Val Ès Dunes,259,206,229,310,124,196,1324
CC Val'aïgo,283,239,257,291,132,208,1410
CC Val-De-Cher-Controis,788,546,596,761,397,648,3736
CC Vallons de Haute-Bretagne Communauté,533,530,534,670,332,512,3111
CC Vallée de l'Ubaye - Serre-Ponçon,187,123,173,192,91,104,870
CC Vallée de l'hérault,742,689,738,836,336,631,3972
CC Vallée de la Dordogne et Forêt Bessède,189,88,126,161,75,100,739
CC Vallée des Baux-Alpilles (Cc Vba),634,349,398,465,187,291,2324
CC Vallées de l'Orne et de l'Odon,251,260,279,280,156,216,1442
CC Vallées et Plateau d'Ardenne,373,327,351,451,208,451,2161
CC Vals de Saintonge,851,733,824,991,479,916,4794
"CC Vendée, Sèvre, Autise",256,204,215,283,138,193,1289
CC Ventoux Sud,219,138,150,182,83,118,890
CC Vexin Centre,278,245,257,303,148,221,1452
CC Vienne et Gartempe,542,408,506,486,253,377,2572
CC Vierzon-Sologne-Berry,706,582,596,685,339,749,3657
CC Vézère-Monédières-Millesources,61,41,40,50,30,36,258
CC Xaintrie Val'dordogne,156,111,104,165,77,110,723
CC Yonne Nord,361,282,319,370,150,264,1746
CC d'Aire Sur l'Adour,181,155,194,172,89,132,923
CC d'Altkirch et Environs,642,472,530,664,292,405,3005
"CC d'Arcis, Mailly, Ramerupt",154,121,143,216,125,147,906
CC d'Auberive Vingeanne et Montsaugeonnais,133,94,93,131,61,57,569
CC d'Erdre et Gesvres,795,749,694,821,356,547,3962
CC de Bayeux Intercom,652,399,406,505,237,343,2542
CC de Belle Ile en Mer,211,74,72,113,56,64,590
CC de Bièvre Est,320,229,292,325,125,206,1497
CC de Blavet Bellevue Océan,277,197,232,249,139,215,1309
CC de Blaye,390,356,386,452,206,351,2141
CC de Bléré Val de Cher,326,247,256,329,149,253,1560
CC de Brocéliande,229,197,215,254,145,213,1253
CC de Calvi Balagne,1106,204,111,144,54,30,1649
CC de Cambremer,88,58,61,69,31,62,369
CC de Cattenom et Environs,253,229,236,265,109,151,1243
CC de Charente Limousine,443,367,439,540,267,432,2488
CC de Commercy - Void - Vaucouleurs,345,314,325,401,184,341,1910
CC de Cèze Cévennes,417,335,379,430,197,432,2190
CC de Damvillers Spincourt,108,101,117,122,64,83,595
CC de Desvres-Samer,330,255,297,410,200,324,1816
CC de Domme- Villefranche du Périgord,189,84,111,137,69,104,694
CC de Fium'orbu Castellu,386,185,157,204,72,89,1093
CC de Flandre Intérieure,1445,1151,1318,1531,697,1049,7191
CC de Forez-Est,866,686,739,906,366,556,4119
CC de Freyming-Merlebach,710,526,644,765,328,589,3562
CC de Gevrey-Chambertin et de Nuits-Saint-Georges,338,288,319,369,177,260,1751
CC de Grand Lieu,490,504,471,564,254,397,2680
"CC de Granville, Terre et Mer",727,567,578,702,319,525,3418
CC de Gâtine et Choisilles - Pays de Racan,286,237,252,279,149,262,1465
CC de Gémozac et de la Saintonge Viticole,232,218,241,293,133,228,1345
CC de Hanau- la Petite Pierre,354,253,313,390,159,306,1775
CC de Haute Cornouaille,237,181,209,250,111,228,1216
CC de Lacq-Orthez,794,616,735,861,404,704,4114
CC de Londinières,58,76,75,99,40,88,436
CC de Lévézou Pareloup,43,47,37,46,23,30,226
CC de Marana-Golo,592,313,292,331,125,147,1800
CC de Marie-Galante,287,267,217,293,128,315,1507
CC de Millau Grands Causses,665,461,516,554,244,375,2815
CC de Mimizan,311,223,223,286,127,171,1341
CC de Mirecourt Dompaire,284,190,203,265,119,299,1360
CC de Miribel et du Plateau,310,260,288,296,136,168,1458
CC de Montaigne Montravel et Gurson,186,170,186,233,119,173,1067
CC de Montbenoit,90,64,66,100,33,47,400
CC de Montesquieu,587,490,511,591,260,381,2820
CC de Noblat,117,118,143,170,102,181,831
CC de Parthenay-Gâtine,521,455,490,616,328,516,2926
CC de Petite Camargue,658,514,476,674,298,426,3046
CC de Ploërmel Communauté,704,500,626,608,267,453,3158
"CC de Podensac, des Coteaux de Garonne et de Lestiac-Sur-Garonne,paillet,rions",606,453,478,573,296,472,2878
CC de Pont-Audemer / Val de Risle,505,401,485,526,230,479,2626
CC de Portes Sud Périgord,111,101,106,137,58,102,615
CC de Pouilly en Auxois/Bligny Sur Ouche,130,83,87,111,55,106,572
CC de Puisaye-Forterre,465,340,433,521,231,425,2415
CC de Sablé-Sur-Sarthe,544,448,504,563,263,481,2803
CC de Saint-Méen Montauban,343,274,291,355,182,281,1726
CC de Saulieu,72,69,61,93,52,84,431
CC de Saverne-Marmoutier-Sommerau,552,398,515,573,238,422,2698
CC de Seille et Mauchère ? Grand Couronné,194,172,182,238,117,161,1064
CC de Suippe et Vesle,83,74,74,87,37,68,423
CC de Sélestat,665,482,597,691,317,492,3244
CC de Sézanne-Sud Ouest Marnais,319,211,334,381,155,260,1660
CC de Vendeuvre-Soulaines,136,81,101,161,80,127,686
CC de Ventadour - Egletons - Monédières,137,125,119,123,76,116,696
CC de Vezouze en Piémont,146,121,179,196,123,259,1024
CC de Vie et Boulogne,655,518,588,699,315,500,3275
CC de Villedieu Intercom,219,156,188,223,110,181,1077
"CC de Vitry, Champagne et Der",445,332,430,516,211,385,2319
CC de Yenne,103,66,76,105,35,65,450
CC de l'Agglomération Migennoise,305,233,263,304,138,195,1438
CC de l'Aillantais,107,93,119,134,66,105,624
CC de l'Aire Cantilienne,580,433,512,608,240,406,2779
CC de l'Alsace Bossue,343,256,345,337,182,334,1797
CC de l'Alta Rocca,405,103,79,92,25,36,740
CC de l'Arc Mosellan,434,311,318,450,210,280,2003
CC de l'Argonne Ardennaise,215,192,195,261,94,156,1113
CC de l'Argonne Champenoise,162,127,168,200,74,144,875
CC de l'Ernée,255,192,219,238,89,149,1142
CC de l'Est Guyanais,163,161,175,170,52,103,824
CC de l'Est Lyonnais (Ccel),425,388,429,462,232,280,2216
CC de l'Est de la Somme,374,307,428,479,260,473,2321
CC de l'Estuaire - Canton de Saint Ciers Sur Gironde,322,282,317,387,167,311,1786
CC de l'Ile d'Oléron,793,415,320,442,210,268,2448
CC de l'Ile de Noirmoutier,260,116,117,157,74,126,850
CC de l'Ile de Ré,635,215,213,292,142,227,1724
CC de l'Ile-Rousse - Balagne,635,154,97,121,39,35,1081
CC de l'Oisans,197,178,228,240,83,80,1006
CC de l'Oise Picarde,437,340,412,514,245,414,2362
CC de l'Oriente,174,68,62,66,23,36,429
CC de l'Orvin et de l'Ardusson,126,113,130,148,68,123,708
CC de l'Ouest Corse,405,77,65,78,39,49,713
CC de l'Ouest Guyanais,1259,1041,1156,1066,457,528,5507
CC de l'Ouest Vosgien,345,292,309,372,214,380,1912
CC de l'Oust À Brocéliande Communauté,568,410,500,592,236,418,2724
CC de l'Outre-Forêt,219,144,188,246,101,165,1063
CC de la Baie du Cotentin,344,296,324,370,191,263,1788
CC de la Basse-Zorn,171,140,145,180,98,147,881
CC de la Beauce Loirétaine,189,164,165,203,129,210,1060
CC de la Brie Champenoise,103,78,97,124,46,77,525
CC de la Castagniccia-Casinca,310,187,174,198,87,102,1058
CC de la Champagne Conlinoise et du Pays de Sillé,264,224,233,305,153,263,1442
CC de la Champagne Picarde,268,264,273,362,195,418,1780
CC de la Châtaigneraie Cantalienne,234,160,177,222,100,155,1048
CC de la Châtre et Sainte Sévère,223,180,217,232,129,203,1184
"CC de la Cléry, du Betz et de l'Ouanne",301,242,312,329,177,300,1661
CC de la Costa Verde,294,136,126,149,66,77,848
CC de la Côtière À Montluel,345,271,333,346,138,157,1590
CC de la Dombes,507,382,394,484,178,210,2155
CC de la Forêt,179,171,191,206,125,179,1051
CC de la Gascogne Toulousaine,286,256,238,266,125,181,1352
CC de la Grande Vallée de la Marne,187,155,184,182,99,187,994
CC de la Haute Ariège,147,95,124,134,51,92,643
CC de la Haute Comté,318,212,243,289,112,249,1423
CC de la Haute Deûle,338,284,299,362,177,388,1848
CC de la Haute Saintonge,1107,973,1003,1262,606,985,5936
CC de la Haute Somme,506,372,507,613,305,719,3022
CC de la Haute Vallée de Chevreuse,216,172,210,213,82,125,1018
CC de la Haute Vallée de l'Ognon,138,118,99,152,45,144,696
CC de la Haute Vallée de la Gravona,197,115,108,112,29,55,616
CC de la Haute-Bigorre,326,213,285,303,138,285,1550
CC de la Lomagne Gersoise,307,241,289,326,139,198,1500
CC de la Lomagne Tarn-Et-Garonnaise,171,139,145,157,82,81,775
CC de la Marche Berrichonne,52,52,54,60,34,49,301
CC de la Matheysine,322,207,207,273,123,207,1339
CC de la Moivre À la Coole,79,83,90,86,43,78,459
CC de la Montagne Noire,109,85,66,125,48,101,534
CC de la Montagne d'Ardèche,60,41,33,59,38,45,276
CC de la Mossig et du Vignoble,279,221,259,319,137,230,1445
CC de la Muse et des Raspes du Tarn,77,57,71,65,33,42,345
CC de la Picardie Verte,467,387,439,591,228,474,2586
CC de la Pieve de l'Ornano,368,157,133,140,45,79,922
CC de la Plaine Dijonnaise,250,202,230,279,167,261,1389
CC de la Plaine Jurassienne,127,82,102,98,60,92,561
CC de la Plaine d'Estrées,201,184,223,275,121,200,1204
CC de la Plaine de l'Ain,1329,1020,1193,1226,492,590,5850
CC de la Plaine du Nord Loiret,103,66,73,105,47,82,476
CC de la Plaine du Rhin,163,142,138,191,100,180,914
CC de la Porte des Vosges Méridionales,503,357,457,515,247,486,2565
CC de la Région d'Audruicq,387,385,356,456,238,390,2212
CC de la Région d'Orgelet,82,45,47,67,27,31,299
CC de la Région d'Yvetot,377,325,366,420,218,408,2114
CC de la Région de Bar Sur Aube,223,138,176,224,89,224,1074
CC de la Région de Blain,250,214,211,247,124,199,1245
CC de la Région de Condrieu,215,179,177,226,101,148,1046
CC de la Région de Guebwiller,627,443,522,653,290,443,2978
CC de la Région de Levroux,90,76,77,97,44,81,465
CC de la Région de Molsheim-Mutzig,500,419,519,546,265,392,2641
CC de la Région de Nozay,240,167,206,237,111,191,1152
CC de la Région de Rambervillers,208,178,183,225,105,235,1134
CC de la Save Au Touch,589,503,594,631,270,380,2967
CC de la Sologne des Etangs,120,82,87,117,50,104,560
CC de la Sologne des Rivières,160,126,142,191,88,168,875
CC de la Station des Rousses-Haut Jura,153,96,118,127,42,49,585
CC de la Tenarèze,270,200,217,243,127,185,1242
CC de la Terre des Deux Caps,335,270,315,371,200,350,1841
CC de la Thiérache du Centre,430,421,483,529,230,542,2635
CC de la Vallée Verte,113,94,99,106,42,36,490
CC de la Vallée d'Ossau,202,102,126,157,68,124,779
CC de la Vallée de Chamonix-Mont-Blanc,311,205,203,179,69,61,1028
CC de la Vallée de Kaysersberg,183,153,192,221,111,147,1007
CC de la Vallée de Munster,226,142,176,222,103,193,1062
CC de la Vallée de Saint-Amarin,162,118,184,197,79,134,874
CC de la Vallée de Villé,127,96,111,126,54,109,623
CC de la Vallée de l'Oise et des Trois Forêts,473,411,407,462,221,278,2252
CC de la Vallée de l'homme,405,197,187,273,98,186,1346
CC de la Vallée de la Bruche,259,212,290,374,160,327,1622
CC de la Vallée de la Doller et du Soultzbach,212,166,191,266,106,134,1075
CC de la Vallée de la Haute Sarthe,93,90,83,103,50,67,486
CC de la Vallée du Gapeau,530,344,402,437,187,309,2209
CC de la Vallée du Garon (Ccvg),365,284,339,378,150,187,1703
CC de la Vallée du Lot et du Vignoble,226,156,223,243,105,239,1192
CC de la Vanne et du Pays d'Othe,113,107,120,161,65,105,671
CC de la Veyle,295,228,250,288,141,184,1386
CC des 2 Vallées,217,135,162,194,90,105,903
CC des 4 Rivières,473,372,392,495,247,417,2396
CC des 4b Sud Charente,293,267,275,324,181,267,1607
CC des 7 Vallées,478,381,414,528,261,370,2432
CC des Albères et de la Côte Vermeille,1828,1125,1002,1377,647,981,6960
CC des Aspres,503,419,384,482,236,420,2444
CC des Ballons des Hautes-Vosges,246,192,222,257,144,297,1358
CC des Baronnies en Drôme Provençale,481,346,390,465,246,374,2302
CC des Bastides Dordogne-Périgord,308,209,205,321,137,233,1413
CC des Bastides en Haut Agenais Périgord,250,154,233,268,119,210,1234
CC des Campagnes de l'Artois,424,363,364,450,215,340,2156
CC des Causses À l'Aubrac,164,138,130,174,79,123,808
CC des Collines du Nord Dauphiné,292,262,274,306,122,146,1402
CC des Collines du Perche,76,63,76,75,49,88,427
CC des Collines du Perche Normand,174,139,159,200,89,134,895
CC des Combes,96,71,68,93,45,62,435
CC des Coteaux Arrats Gimone,166,90,125,137,84,96,698
CC des Coteaux Bellevue,249,209,217,219,111,161,1166
CC des Coteaux Bordelais,270,219,222,276,126,175,1288
CC des Coteaux de Pouyastruc et du Canton de Tournay,161,138,126,121,63,91,700
CC des Coteaux du Girou,254,194,232,304,138,225,1347
CC des Coteaux et Landes de Gascogne,216,161,182,224,106,157,1046
CC des Coëvrons,339,276,301,405,171,260,1752
CC des Crêtes Préardennaises,280,229,281,313,182,280,1565
CC des Cévennes Au Mont Lozère,89,61,50,67,44,65,376
CC des Cévennes Gangeoises et Suménoises,313,243,261,282,131,246,1476
CC des Deux Morin,418,328,365,416,168,265,1960
CC des Deux Rives,378,277,337,384,161,228,1765
CC des Deux Vallées,333,276,334,434,206,396,1979
CC des Deux Vallées Vertes,182,179,197,234,105,181,1078
CC des Forêts du Perche,97,98,124,128,83,113,643
CC des Gorges de l'Ardèche,569,334,285,442,206,329,2165
CC des Grands Lacs,782,538,508,636,280,371,3115
CC des Hautes Terres de l'Aubrac,60,29,38,32,14,35,208
CC des Hautes Vosges,547,412,536,541,261,523,2820
CC des Hauts de Flandre,707,534,651,728,371,676,3667
CC des Hauts du Perche,141,100,120,139,46,80,626
CC des Hauts du Val de Saône,142,83,102,105,50,86,568
CC des Lacs de Champagne,153,92,134,170,75,137,761
CC des Lacs et Montagnes du Haut-Doubs,285,180,189,253,121,80,1108
CC des Landes d'Armagnac,175,149,143,175,85,116,843
CC des Lisières de l'Oise,213,180,220,267,146,241,1267
CC des Loges,520,458,473,587,361,467,2866
CC des Luys en Béarn,361,306,324,426,180,249,1846
"CC des Marchés du Périg Or Limousin, Thiviers-Jumilhac",225,138,205,209,89,142,1008
CC des Montagnes du Giffre,180,165,181,182,83,98,889
CC des Monts d'Alban et du Villefranchois,82,62,78,85,37,53,397
CC des Monts de Gy,88,78,63,87,39,69,424
CC des Monts de Lacaune et de la Montagne du Haut Languedoc,112,87,76,113,61,86,535
CC des Monts du Lyonnais,326,294,331,342,150,241,1684
CC des Monts du Pilat,183,161,166,171,80,151,912
CC des Pays d'Oise et d'halatte,562,462,515,615,263,420,2837
"CC des Pays de Briey, du Jarnisy et de L?orne",867,684,736,1030,455,860,4632
"CC des Pays de Caldaguès-Aubrac, Pierrefort-Neuvéglise, Planèze, Saint-Flour Margeride",397,226,217,208,94,128,1270
CC des Pays de Cayres et de Pradelles,60,39,58,67,34,52,310
CC des Pays de Rhône et Ouvèze,1104,858,940,1072,543,764,5281
CC des Pays de l'Aigle,460,392,381,396,184,310,2123
CC des Pays du Sel et du Vermois,349,308,361,412,224,392,2046
CC des Paysages de la Champagne,288,232,242,306,123,210,1401
CC des Portes Euréliennes D Ile de France,722,643,733,853,398,631,3980
CC des Portes d'Ariège Pyrénées,841,677,699,740,311,492,3760
CC des Portes de Romilly Sur Seine,483,380,425,528,212,402,2430
CC des Portes de Rosheim,198,153,181,200,111,162,1005
CC des Portes de Sologne,174,140,154,225,109,150,952
CC des Portes de Vassivière,69,57,55,88,40,85,394
CC des Portes de l'Entre Deux Mers,268,254,257,354,172,285,1590
CC des Portes de la Thiérache,110,92,89,167,81,196,735
CC des Portes du Luxembourg,329,260,295,394,178,346,1802
CC des Quatre Rivières,453,288,345,408,149,192,1835
CC des Quatre Territoires,109,56,64,87,35,39,390
CC des Quatre Vallées,247,186,205,281,123,218,1260
CC des Rives du Haut Allier,255,213,206,264,121,229,1288
CC des Sablons,639,512,610,676,297,420,3154
CC des Savanes,999,900,860,595,264,379,3997
CC des Sorgues du Comtat,1102,836,950,1124,462,816,5290
CC des Sources de l'Orne,176,140,137,156,78,103,790
CC des Sources du Lac d'Annecy,279,181,177,230,91,130,1088
CC des Sucs,263,235,223,256,127,211,1315
CC des Terres d'Apcher-Margeride-Aubrac,117,76,86,94,51,63,487
CC des Terres d'Auxois,195,165,170,218,121,185,1054
CC des Terres du Lauragais,534,464,462,599,270,482,2811
CC des Terres du Val de Loire,631,495,567,726,360,571,3350
CC des Trois Forêts,97,85,81,106,52,48,469
CC des Vallons du Lyonnais (Ccvl),350,288,287,327,155,173,1580
CC des Vallées d'Aigueblanche,201,56,95,77,24,36,489
CC des Vallées d'Auge et du Merlerault,247,161,199,246,100,186,1139
CC des Vallées de Thônes,278,186,238,235,103,110,1150
CC des Vallées de la Braye et de l'Anille,205,159,179,206,104,210,1063
CC des Vallées de la Tille et de l'Ignon,187,129,143,168,92,165,884
CC des Vallées du Clain,264,249,252,307,161,239,1472
CC des Vallées du Haut-Anjou,568,458,449,512,223,416,2626
CC des Vals d'Aix et Isable,99,64,73,65,30,66,397
CC des Villes Soeurs,649,513,612,738,409,776,3697
CC des Vosges Côté Sud Ouest,155,116,132,171,109,189,872
CC des Vosges du Sud,207,149,157,236,85,154,988
CC du Barséquanais en Champagne,281,220,238,314,179,300,1532
CC du Bas Armagnac,145,90,108,118,56,95,612
CC du Bassin d'Arcachon Nord Atlantique (Coban Atlantique),1306,968,974,1199,533,823,5803
CC du Bassin d'Aubenas,892,664,733,947,412,792,4440
CC du Bassin de Joinville en Champagne,235,164,173,247,131,221,1171
CC du Bassin de Marennes,321,226,239,311,140,217,1454
CC du Bassin de Mortagne Au Perche,220,162,168,196,97,136,979
CC du Bassin de Pompey,533,471,580,706,328,546,3164
CC du Bassin de Pont-À-Mousson,612,540,611,716,308,487,3274
CC du Bazadais,232,205,264,309,124,277,1411
CC du Bocage Bourbonnais,217,149,160,200,92,206,1024
CC du Bocage Mayennais,218,132,160,211,103,160,984
CC du Bonnevalais,163,158,145,174,91,137,868
CC du Briançonnais,491,371,422,485,197,280,2246
CC du Brivadois,307,232,244,294,123,249,1449
CC du Béarn des Gaves,259,184,213,236,122,184,1198
CC du Canton d'Erstein,683,463,508,691,327,439,3111
CC du Canton d'Oulchy le Château,74,62,88,111,53,98,486
CC du Canton de Charly Sur Marne,212,219,257,273,140,223,1324
CC du Canton de Criquetot-l'esneval,215,156,178,208,106,156,1019
CC du Canton de Marcigny,61,60,74,69,40,69,373
CC du Canton de Pierre de Bresse,105,59,77,88,32,66,427
CC du Canton de Rumilly,481,378,381,382,157,203,1982
CC du Canton de Semur en Brionnais,62,47,56,75,35,51,326
CC du Canton de Vatan et de Champagne Berrichonne,137,118,135,157,63,133,743
CC du Canton de la Chambre,109,78,98,87,50,50,472
CC du Cap Corse,191,94,87,75,44,44,535
CC du Castelrenaudais,284,221,227,305,179,222,1438
CC du Caudrésis et du Catésis,1311,1152,1485,1612,730,1478,7768
CC du Causse de Labastide Murat,66,31,38,59,25,46,265
"CC du Cellois, Coeur du Poitou, Mellois et du Val de Boutonne",597,549,528,696,285,453,3108
CC du Centre Corse,202,88,84,89,28,49,540
CC du Centre du Haut-Rhin,192,146,198,213,105,139,993
CC du Chaourçois et du Val d'Armance,125,113,165,183,83,134,803
CC du Chemin des Dames,76,93,79,95,57,83,483
CC du Châtillonnais en Berry,61,68,82,91,41,87,430
CC du Civraisien en Poitou,355,256,318,376,167,319,1791
CC du Clermontais,615,552,586,682,298,534,3267
CC du Clermontois,546,451,503,648,269,393,2810
CC du Clunisois,171,146,163,178,72,113,843
CC du Confluent et des Coteaux de Prayssas,358,286,320,421,216,374,1975
CC du Cordais et du Causse (4 C),67,41,92,71,33,72,376
CC du Crestois et de Pays de Saillans Coeur de Drôme,439,296,341,400,164,301,1941
CC du Créonnais,268,226,233,295,159,258,1439
CC du Cubzaguais,616,525,587,704,310,460,3202
CC du Diois,298,213,261,281,126,201,1380
CC du District Urbain de Faulquemont (Duf),364,303,363,396,171,285,1882
CC du Doubs Baumois,218,173,210,239,117,169,1126
CC du Fronsadais,277,196,244,281,152,245,1395
CC du Frontonnais,371,322,340,388,165,287,1873
CC du Genevois,733,546,644,558,184,211,2876
CC du Golfe de Saint-Tropez,3620,1001,803,1336,600,594,7954
CC du Grand Armagnac,233,183,180,238,107,191,1132
CC du Grand Autunois Morvan,537,476,458,591,342,579,2983
CC du Grand Chambord,266,226,210,307,162,224,1395
CC du Grand Châteaudun,635,477,515,550,271,500,2948
CC du Grand Langres,408,236,296,326,133,199,1598
CC du Grand Pic Saint-Loup,674,571,585,721,314,493,3358
CC du Grand Pontarlier,547,358,445,485,184,237,2256
CC du Grand Roye,491,349,475,538,290,396,2539
CC du Grand Saint Emilonnais,267,228,209,289,112,206,1311
CC du Grand Villefranchois,438,329,359,438,169,252,1985
CC du Guillestrois et du Queyras,205,131,165,193,102,123,919
CC du Gâtinais en Bourgogne,230,193,230,307,134,222,1316
CC du Gévaudan,141,100,94,117,50,81,583
CC du Haut Allier,71,55,49,62,20,43,300
CC du Haut Lignon,129,92,81,106,51,93,552
CC du Haut Pays Bigouden,270,253,244,264,162,200,1393
CC du Haut Pays du Montreuillois,212,154,179,231,125,174,1075
CC du Haut Val d'Oise,731,646,620,601,259,318,3175
CC du Haut Vallespir,283,130,164,218,84,159,1038
CC du Haut-Chablais,182,147,180,174,82,87,852
CC du Haut-Jura (Arcade),227,126,153,164,70,78,818
CC du Haut-Poitou,519,454,544,583,290,442,2832
CC du Jovinien,361,327,330,385,191,265,1859
CC du Kochersberg,227,160,207,288,117,172,1171
CC du Kreiz-Breizh (Cckb),292,249,256,278,120,256,1451
CC du Lac d'Aiguebelette (Ccla),82,51,79,85,38,35,370
CC du Lautrécois et du Pays d'Agout,200,181,201,262,105,174,1123
CC du Liancourtois,362,301,357,390,167,297,1874
CC du Limouxin,539,425,492,541,219,415,2631
CC du Massif du Sancy,214,115,121,203,87,153,893
CC du Massif du Vercors,188,164,171,194,77,136,930
CC du Mont des Avaloirs,237,148,178,187,109,184,1043
CC du Montbardois,167,154,156,155,90,166,888
CC du Nivernais Bourbonnais,71,49,64,58,30,59,331
CC du Nogentais,307,221,255,310,133,216,1442
CC du Nord Est Béarn,477,365,405,453,196,279,2175
CC du Pays Arnay Liernais,82,73,72,84,41,89,441
CC du Pays Beaume-Drobie,205,159,199,236,107,171,1077
CC du Pays Bellegardien (Ccpb),405,308,334,427,183,247,1904
CC du Pays Bigouden Sud,640,494,482,547,277,474,2914
CC du Pays Châtillonnais,241,270,299,349,160,298,1617
CC du Pays Entre Loire et Rhône,195,132,157,172,93,150,899
CC du Pays Fertois,475,382,417,451,215,303,2243
CC du Pays Fertois et du Bocage Carrougien,72,42,44,66,29,49,302
CC du Pays Fléchois,389,390,368,390,209,398,2144
CC du Pays Fouesnantais,454,336,333,405,205,266,1999
CC du Pays Foyen,301,251,294,384,203,299,1732
CC du Pays Gentiane,55,42,62,51,25,43,278
CC du Pays Grenadois,136,98,81,119,54,92,580
CC du Pays Haut Val d'Alzette,372,307,343,443,180,333,1978
"CC du Pays Houdanais (C,C,P,H,)",334,281,267,303,145,210,1540
CC du Pays Loudunais,488,335,382,470,228,451,2354
CC du Pays Morcenais,161,132,135,182,73,137,820
CC du Pays Mornantais (Copamo),313,288,259,302,144,184,1490
CC du Pays Noyonnais,673,619,663,793,366,637,3751
CC du Pays Orne Moselle,920,738,894,1150,496,788,4986
CC du Pays Rhénan,408,323,346,482,260,407,2226
CC du Pays Ribéracois,287,219,275,296,119,259,1455
CC du Pays Rignacois,66,53,47,68,34,41,309
CC du Pays Riolais,168,142,129,164,89,95,787
CC du Pays Rochois,427,326,340,344,108,135,1680
CC du Pays Roussillonnais,1151,798,786,854,361,370,4320
CC du Pays Réthelois,481,320,414,504,228,327,2274
CC du Pays Solesmois,234,254,221,331,130,293,1463
CC du Pays Tarusate,320,222,259,277,138,229,1445
CC du Pays Viganais,240,190,240,215,95,180,1160
CC du Pays d'Alésia et de la Seine,101,74,91,98,48,93,505
CC du Pays d'Ancenis,990,837,845,1073,478,790,5013
CC du Pays d'Etain,107,84,109,114,58,103,575
CC du Pays d'Iroise,624,500,472,570,274,418,2858
CC du Pays d'Issoudun,374,270,293,368,179,365,1849
CC du Pays d'Olmes,318,251,312,327,146,265,1619
CC du Pays d'Oloron et des Vallées du Haut Béarn,743,374,456,505,224,372,2674
CC du Pays d'Othe Aixois,116,108,120,158,62,109,673
CC du Pays d'Urfé,67,43,52,50,29,62,303
CC du Pays d'Uzerche,107,93,90,114,53,71,528
CC du Pays d'huriel,107,75,97,106,57,115,557
CC du Pays d'héricourt,335,272,323,360,151,285,1726
CC du Pays de Barr,307,258,330,378,180,236,1689
CC du Pays de Bitche,442,375,409,505,213,433,2377
CC du Pays de Bray,317,229,287,323,167,302,1625
CC du Pays de Bâgé et de Pont-De-Vaux,304,259,301,329,129,209,1531
"CC du Pays de Chalindrey, de Vannier Amance et de la Région de Bourbonne-Les-Bains",239,169,175,221,117,156,1077
CC du Pays de Château-Gontier,367,347,372,467,215,365,2133
CC du Pays de Châteaugiron,325,280,270,265,154,184,1478
CC du Pays de Colombey et du Sud Toulois,163,120,123,155,67,111,739
CC du Pays de Conches,307,215,270,330,162,326,1610
CC du Pays de Craon,342,282,293,385,181,243,1726
CC du Pays de Cruseilles,196,157,183,196,67,65,864
CC du Pays de Dol et de la Baie du Mont Saint-Michel,366,279,310,362,175,290,1782
CC du Pays de Duras,80,65,69,100,46,72,432
CC du Pays de Falaise,452,390,455,507,221,310,2335
CC du Pays de Fayence,563,385,386,452,178,239,2203
CC du Pays de Fénelon,225,122,133,148,69,113,810
CC du Pays de Gex,1368,976,1214,1200,421,388,5567
CC du Pays de Honfleur-Beuzeville,671,422,439,522,259,363,2676
CC du Pays de Lalbenque-Limogne,125,104,123,129,73,113,667
CC du Pays de Lamastre,87,80,97,104,54,97,519
CC du Pays de Landerneau-Daoulas,679,616,617,747,379,556,3594
CC du Pays de Landivisiau,475,404,471,536,321,464,2671
CC du Pays de Lanouaille,159,120,168,187,74,126,834
CC du Pays de Lapalisse,120,71,114,127,75,143,650
CC du Pays de Lauzun,170,109,137,135,76,121,748
CC du Pays de Limours (Ccpl),215,192,159,235,85,110,996
CC du Pays de Loiron,200,186,167,218,106,131,1008
CC du Pays de Lubersac-Pompadour,102,74,85,111,47,73,492
CC du Pays de Lumbres,330,266,319,382,166,338,1801
CC du Pays de Lunel,1278,1049,1082,1381,609,1045,6444
CC du Pays de Lure,351,245,281,385,166,348,1776
CC du Pays de Luxeuil,248,205,223,288,125,225,1314
CC du Pays de Mauriac,103,60,66,75,33,52,389
CC du Pays de Maîche,260,202,225,287,147,151,1272
CC du Pays de Meslay-Grez,175,150,175,186,86,133,905
CC du Pays de Mirepoix,228,156,195,202,78,143,1002
CC du Pays de Montbozon et du Chanois,85,59,60,99,35,64,402
CC du Pays de Montfaucon,93,78,81,89,44,92,477
CC du Pays de Montmédy,88,57,86,101,41,79,452
CC du Pays de Mormal,694,653,703,870,358,587,3865
CC du Pays de Mortagne,368,289,304,377,141,278,1757
CC du Pays de Niederbronn-Les-Bains,302,235,253,395,156,299,1640
CC du Pays de Phalsbourg,248,168,215,215,107,131,1084
CC du Pays de Pierrefontaine - Vercel,326,230,269,273,111,125,1334
CC du Pays de Pontchâteau St Gildas des Bois,553,450,504,563,279,482,2831
CC du Pays de Pouzauges,335,295,286,323,153,236,1628
CC du Pays de Redon,1104,975,972,1195,574,1075,5895
CC du Pays de Revigny Sur Ornain,86,82,106,99,58,91,522
CC du Pays de Ribeauvillé,234,145,183,246,104,162,1074
"CC du Pays de Rouffach, Vignobles et Châteaux",135,97,104,132,70,111,649
CC du Pays de Saint Aulaye,113,96,90,107,48,92,546
CC du Pays de Saint Yrieix,161,140,149,152,99,173,874
CC du Pays de Saint-Eloy,241,151,193,210,79,163,1037
CC du Pays de Saint-Fulgent - les Essarts,363,314,280,379,157,266,1759
CC du Pays de Sainte-Odile,244,217,254,308,140,226,1389
CC du Pays de Salars,85,76,74,75,34,36,380
CC du Pays de Salers,118,67,83,95,35,53,451
CC du Pays de Sancey-Belleherbe,60,57,49,71,24,37,298
CC du Pays de Serres en Quercy,193,98,124,155,66,106,742
CC du Pays de Sommières,432,331,388,440,249,413,2253
CC du Pays de St Gilles-Croix-De-Vie,977,685,651,903,425,737,4378
CC du Pays de Stenay et du Val Dunois,124,111,133,148,69,138,723
CC du Pays de Tarascon,191,97,130,173,66,104,761
CC du Pays de Thelle et Ruraloise,857,691,818,967,430,593,4356
CC du Pays de Trie et du Magnoac,77,74,71,78,34,63,397
CC du Pays de Tronçais,103,77,81,108,60,129,558
CC du Pays de Valois,736,629,680,905,455,665,4070
CC du Pays de Villeneuve en Armagnac Landais,89,91,76,97,32,69,454
CC du Pays de Villersexel,115,86,106,115,54,121,597
CC du Pays de Wissembourg,206,182,184,261,120,186,1139
CC du Pays de l'Arbresle (Ccpa),490,412,410,410,252,350,2324
CC du Pays de l'Ourcq,257,239,221,298,123,178,1316
CC du Pays de l'Ozon,311,261,268,275,108,165,1388
CC du Pays de l'huisne Sarthoise,469,347,441,457,206,413,2333
CC du Pays de la Châtaigneraie,196,175,171,221,109,204,1076
CC du Pays de la Serre,218,209,253,307,167,382,1536
CC du Pays de la Zorn,148,147,159,171,75,123,823
CC du Pays des Abers,572,447,440,594,285,419,2757
CC du Pays des Achards,289,194,238,293,150,217,1381
CC du Pays des Ecrins,139,107,135,129,70,70,650
CC du Pays des Herbiers,452,408,339,441,197,349,2186
CC du Pays des Lacs,102,77,85,82,39,40,425
CC du Pays des Paillons,444,294,343,390,160,201,1832
CC du Pays des Sorgues et des Monts de Vaucluse,710,498,576,670,359,487,3300
CC du Pays des Sources,334,244,293,388,165,291,1715
CC du Pays des Trois Rivières,440,371,446,488,218,451,2414
CC du Pays du Coquelicot,435,335,456,489,273,495,2483
CC du Pays du Neubourg,227,194,236,285,141,321,1404
CC du Pays du Saintois,149,133,153,197,84,128,844
CC du Pays du Sanon,62,64,69,74,40,71,380
CC du Pays du Vermandois,491,440,509,667,311,693,3111
CC du Perche,343,253,272,309,138,308,1623
CC du Perche et Haut Vendômois,120,95,94,111,65,106,591
CC du Pilat Rhodanien,233,188,189,279,102,175,1166
CC du Pithiverais,588,405,455,552,290,456,2746
CC du Pithiverais-Gâtinais,423,298,378,459,233,373,2164
CC du Piémont Cévenol,459,361,391,411,212,366,2200
CC du Plateau Picard,487,402,463,552,237,358,2499
CC du Plateau d'hauteville,88,42,68,52,31,44,325
CC du Plateau de Frasne et du Val de Drugeon (Cfd),88,57,76,90,36,37,384
CC du Plateau de Lannemezan,314,200,227,284,130,231,1386
CC du Plateau de Montbazens,65,60,63,56,26,32,302
CC du Plateau de Russey,77,63,76,102,31,31,380
CC du Pont du Gard,501,375,448,497,256,371,2448
CC du Provinois,577,470,475,539,223,386,2670
CC du Périgord Nontronnais,207,165,179,197,98,126,972
CC du Quercy Blanc,117,94,94,102,58,109,574
CC du Quercy Caussadais,445,309,323,409,191,305,1982
CC du Quercy Rouergue et des Gorges de l'Aveyron,139,95,139,138,74,102,687
CC du Rhône Aux Gorges de l'Ardèche,439,311,408,452,202,360,2172
CC du Ried de Marckolsheim,303,200,248,312,152,219,1434
CC du Romorantinais et du Monestois,596,427,533,555,281,547,2939
CC du Rouillacais,152,137,138,177,69,186,859
CC du Royans-Vercors,156,114,125,152,76,112,735
CC du Réolais en Sud Gironde,425,411,434,435,223,416,2344
CC du Réquistanais,45,29,41,41,28,21,205
CC du Sammiellois,124,107,126,142,65,178,742
CC du Sartenais Valinco,632,169,125,120,41,39,1126
CC du Saulnois,376,303,358,383,182,293,1895
CC du Saves,144,88,118,111,53,88,602
CC du Secteur de Saint Loubes,404,391,355,477,202,308,2137
CC du Seignanx,500,388,445,437,243,305,2318
CC du Serein,82,57,82,78,46,56,401
CC du Sisteronais-Buëch,507,388,387,523,231,388,2424
CC du Sor et de l'Agout,346,296,337,354,159,295,1787
CC du Sud Avesnois,597,514,586,641,291,568,3197
CC du Sud Corse,1997,383,231,262,86,68,3027
CC du Sud Est du Pays Manceau,192,191,165,231,103,188,1070
CC du Sud Estuaire,479,385,357,508,247,407,2383
CC du Sud Gironde,784,648,741,865,403,714,4155
CC du Sud Grésivaudan,694,564,624,684,356,572,3494
CC du Sud Marnais,111,60,122,125,64,95,577
CC du Sud Messin,168,144,154,211,107,123,907
CC du Sud Territoire,428,300,405,471,189,295,2088
CC du Sud-Artois,416,311,397,439,198,312,2073
CC du Ternois,653,492,565,566,270,427,2973
CC du Terrassonnais en Périgord Noir Thenon Hautefort,470,308,304,352,162,281,1877
CC du Territoire Nord Picardie,507,437,528,591,376,603,3042
CC du Territoire de Beaurepaire,240,202,236,254,126,184,1242
CC du Territoire de Fresnes en Woëvre,61,41,56,72,32,51,313
CC du Territoire de Lunéville À Baccarat,645,529,627,809,386,831,3827
CC du Thouarsais,643,481,511,643,285,481,3044
CC du Triangle Vert,138,106,126,178,74,122,744
CC du Trièves,135,103,129,159,89,102,717
CC du Val D Amboise,558,448,426,515,274,428,2649
CC du Val Marnaysien,155,139,162,198,89,118,861
CC du Val d'Amour,109,83,88,119,48,79,526
CC du Val d'Argent,161,115,148,174,85,154,837
CC du Val d'Ay,88,68,71,79,42,48,396
CC du Val d'Essonne (Ccve),657,531,562,573,255,388,2966
CC du Val d'Ille-Aubigné,454,429,416,472,248,336,2355
CC du Val d'Orne,72,58,60,74,48,73,385
CC du Val de Bouzanne,74,72,69,104,39,73,431
CC du Val de Cher,78,57,63,84,38,99,419
CC du Val de Drôme,598,455,511,610,231,445,2850
CC du Val de Morteau,353,243,246,405,131,127,1505
CC du Val de Sarthe,355,345,319,386,208,339,1952
CC du Val de Somme,334,264,323,418,221,398,1958
CC du Val de Sully,374,280,325,441,184,359,1963
CC du Val de Vienne,165,139,153,168,95,134,854
CC du Val de l'Aisne,286,254,292,414,188,406,1840
CC du Val de l'Eyre,333,243,306,386,147,269,1684
CC du Val de l'Oise,207,236,234,320,158,370,1525
CC du Vallespir,447,391,371,437,210,350,2206
CC du Vexin Normand,583,432,560,582,300,466,2923
CC du Vexin-Thelle,282,204,266,333,142,202,1429
CC du Vexin-Val de Seine,256,183,216,259,143,185,1242
CC du Vimeu,372,294,361,407,207,421,2062
CC du Volvestre,445,425,448,521,250,473,2562
CC du Warndt,365,245,339,408,171,304,1832
CC l'Orée de la Brie,338,298,301,334,136,152,1559
CC la Clayette Chauffailles en Brionnais,180,151,164,209,104,176,984
CC la Domitienne,604,484,427,631,264,422,2832
CC la Grandvallière,92,59,74,79,38,31,373
CC la Rochefoucauld - Porte du Périgord,310,244,281,351,172,301,1659
CC la Septaine,129,104,123,135,86,141,718
CC le Dourdannais en Hurepoix (Ccdh),363,247,274,266,134,167,1451
CC le Dunois,101,76,86,98,57,84,502
CC le Gesnois Bilurien,417,355,401,442,229,392,2236
CC le Grand Charolais,586,459,524,531,275,501,2876
CC le Grésivaudan,1308,1011,1176,1310,589,743,6137
CC le Tonnerrois en Bourgogne,236,212,210,286,121,166,1231
CC les Avant-Monts,535,391,421,565,254,438,2604
CC les Balcons du Dauphiné,1101,937,1022,1206,500,634,5400
CC les Portes Briardes Entre Villes et Forêts,589,516,524,590,255,361,2835
CC les Portes de l'Ile de France,296,278,276,364,156,237,1607
CC les Trois Provinces,69,73,71,74,38,81,406
CC les Vals du Dauphiné,987,816,914,967,447,562,4693
CC les Versants d'Aime,189,109,154,104,45,29,630
CC les Villages de la Forêt,81,52,66,77,46,75,397
CU Angers Loire Métropole,6072,4926,5232,5947,2865,5417,30459
CU Caen la Mer,5701,4437,4542,5494,2391,3896,26461
CU Clermont Auvergne Métropole,5363,4083,4618,4980,2261,4182,25487
CU Grand Paris Seine et Oise,7855,6269,7137,7893,3292,5067,37513
CU Orléans Métropole,5605,4453,4961,5699,2700,4579,27997
CU Perpignan Méditerranée Métropole,6668,5268,5203,6586,3105,5121,31951
CU Saint-Etienne Métropole,8099,6375,6904,7730,3516,6438,39062
CU Tour(S) Plus,6447,5053,5018,6093,2673,4307,29591
CU d'Alençon,1109,766,818,895,383,584,4555
CU d'Arras,1926,1615,1758,2122,940,1560,9921
CU de Dunkerque,4392,3412,3767,4623,2198,3671,22063
CU du Grand Dijon,4678,3784,4086,4626,2097,3526,22797
CU du Grand Reims,5388,4153,4680,5496,2528,4443,26688
CU le Creusot Montceau-Lès-Mines,1485,1369,1388,1785,828,1534,8389
CU le Mans Métropole,4791,3684,4017,4493,2096,3950,23031
Eurométropole de Strasbourg,9740,7666,8970,10520,4536,7693,49125
Montpellier Méditerranée Métropole,11909,9544,9418,11163,4717,7760,54511
Métropole Européenne de Lille,24210,18722,21781,23684,10898,21280,120575
Métropole Grenoble-Alpes-Métropole,8429,6556,6819,7119,3100,4518,36541
Métropole Nice Côte d'Azur,13471,8724,9676,11142,4673,6967,54653
Métropole Rouen Normandie,9806,7948,9144,9936,4843,9047,50724
Métropole d'Aix-Marseille-Provence,39908,31346,35380,41163,17017,28013,192827
Métropole de LYON,28228,22197,23943,25253,10924,16903,127448
Métropole du Grand Nancy,4578,3759,3890,4593,2056,3771,22647
Métropole du Grand Paris,128772,98398,115175,124689,53495,105083,625612
Nantes Métropole,12867,10585,11024,12072,5505,9331,61384
Rennes Métropole,8388,7070,6767,7335,3457,5400,38417
Toulouse Métropole,19174,14601,15145,16244,6886,11378,83428
Hors EPCI,2847,2045,2576,5313,2529,5075,20385
