code_epci,lib_epci,anc_moins_3_mois,anc_3_a_5_mois,anc_6_a_11_mois,anc_12_a_23_mois,anc_24_a_35_mois,anc_plus_36_mois,total
243300316.0,Bordeaux Métropole,17137,13820,13778,16557,7651,11375,80318
242900314.0,Brest Métropole,3709,3215,3229,3771,1747,3039,18710
200066918.0,CA Alès Agglomération,2613,2202,2429,2985,1575,2746,14550
248000531.0,CA Amiens Métropole,3741,3105,3293,4338,2074,3663,20214
200011773.0,CA Annemasse-les Voirons-Agglomération,2166,1453,1717,1921,790,841,8888
200072015.0,CA Annonay Rhône Agglo,790,728,696,930,525,725,4394
200041630.0,CA Ardenne Métropole,2081,1677,1999,2602,1500,2697,12556
200068997.0,CA Arlysère,1247,678,659,599,252,327,3762
243300563.0,CA Bassin d'Arcachon Sud-Pôle Atlantique (Cobas),1487,1055,1003,1258,624,955,6382
200006682.0,"CA Beaune, Côte et Sud - Communauté Beaune-Chagny-Nolay",773,542,549,787,389,632,3672
200070647.0,CA Bergeracoise,1144,875,951,1208,592,966,5736
241800507.0,CA Bourges Plus,1795,1375,1352,1700,890,1638,8750
200039915.0,CA Cannes Pays de Lérins,4696,2767,2818,3711,1848,2556,18396
200018653.0,CA Cap Excellence,2416,2110,2405,3313,1898,4916,17058
200035715.0,CA Carcassonne Agglo,2246,1730,1877,2374,1263,2041,11531
200010700.0,CA Caux Seine Agglo,1142,1040,1069,1578,813,1472,7114
200069110.0,CA Chambéry Métropole-Coeur des Bauges,2487,1815,1738,2046,960,1205,10251
200033181.0,CA Chartres Métropole,2234,1826,1937,2568,1194,1918,11677
243600327.0,CA Châteauroux Métropole,1429,1082,1181,1540,771,1253,7256
200071785.0,CA Chauny Tergnier la Fère,969,839,913,1370,634,1169,5894
249740077.0,CA Civis (Communauté Intercommunale des Villes Solidaires),4670,4540,6313,8200,4336,10575,38634
200067635.0,CA Clisson Sèvre et Maine Agglo,722,620,630,745,415,611,3743
200057859.0,CA Coeur d'Essonne Agglomération,3082,2431,2489,2735,1156,1516,13409
246800726.0,CA Colmar Agglomération,1964,1371,1661,1764,954,1516,9230
200056232.0,CA Communauté Paris-Saclay,4279,3398,3376,3883,1745,2250,18931
242900769.0,CA Concarneau Cornouaille Agglomération,952,678,651,817,459,632,4189
200077055.0,CA Coulommiers Pays de Brie,1147,903,987,1150,505,700,5392
200068047.0,CA Creil Sud Oise,2090,1612,1820,2144,1051,1523,10240
200035459.0,CA d'Agen,1744,1459,1500,1800,874,1274,8651
241300417.0,CA d'Arles-Crau-Camargue-Montagnette,2501,1571,1724,2252,1110,1452,10610
200033025.0,CA de Bar-le-Duc - Sud Meuse,555,438,465,543,313,526,2840
242000354.0,CA de Bastia,1138,542,544,609,269,315,3417
200072460.0,"CA de Béthune-Bruay, Artois-Lys Romane",4438,3733,4203,5839,2707,4736,25656
243400769.0,CA de Béziers-Méditerranée,3241,2454,2552,3179,1641,2362,15429
200030385.0,CA de Blois Agglopolys,1934,1401,1585,1929,956,1527,9332
200068500.0,CA de Cambrai,1457,1265,1472,2012,960,1757,8923
248100430.0,CA de Castres Mazamet,1537,1175,1349,1575,772,1186,7594
249500109.0,CA de Cergy-Pontoise,4268,3154,3467,4038,1850,2581,19358
200066876.0,CA de Châlons-en-Champagne,1316,989,1223,1441,761,1016,6746
200068658.0,"CA de Chaumont, du Bassin Nogentais et du Bassin de Bologne Vignory Froncles",687,527,563,659,317,438,3191
245700372.0,CA de Forbach Porte de France,1458,1120,1247,1554,927,1338,7644
200067874.0,CA de Haguenau,1486,1070,1195,1375,748,1194,7068
200070993.0,CA de la Baie de Somme,958,740,800,1032,441,928,4899
200042190.0,CA de la Porte du Hainaut,3160,2681,2880,3985,2037,3406,18149
244400610.0,CA de la Presqu'île de Guérande Atlantique (Cap Atlantique),1492,960,949,1199,634,897,6131
200068104.0,CA de la Provence Verte,1860,1477,1588,1984,916,1257,9082
200072031.0,CA de la Région de Château-Thierry,980,830,945,1191,519,955,5420
200067965.0,CA de la Région de Compiègne et de la Basse Automne,1436,1090,1272,1628,841,1226,7493
247600786.0,CA de la Région Dieppoise,829,735,823,1088,551,1039,5065
244400644.0,CA de la Région Nazairienne et de l'Estuaire (Carene),2621,1990,2039,2519,1290,2038,12497
240600551.0,CA de la Riviera Française,1840,927,1036,1132,545,708,6188
241700434.0,CA de la Rochelle,3402,2664,2711,3447,1603,2515,16342
248100737.0,CA de l'Albigeois (C2a),1561,1261,1290,1506,732,1035,7385
200067114.0,CA de l'Auxerrois,1151,813,822,1083,541,877,5287
245300330.0,CA de Laval,1604,1318,1239,1479,729,1088,7457
246200364.0,CA de Lens - Liévin,4564,3526,4169,5591,2706,4850,25406
249720053.0,CA de l'Espace Sud de la Martinique,2460,2264,2733,3572,1960,3618,16607
245400262.0,CA de Longwy,894,688,807,1012,529,830,4760
200040566.0,CA de l'Ouest Rhodanien,738,631,588,736,346,580,3619
245804406.0,CA de Nevers,1128,702,819,961,446,669,4725
243000643.0,CA de Nîmes Métropole,5825,4615,4658,5900,3048,4748,28794
200071066.0,CA de Saint-Dié-Des-Vosges,1210,962,1106,1479,883,1772,7412
200068666.0,CA de Saint-Dizier Der et Blaise,930,719,791,1209,630,1009,5288
200036473.0,CA de Saintes,967,825,860,1175,592,890,5309
200058782.0,CA de Saint-Quentin-en-Yvelines,3495,2775,2986,3643,1699,2007,16605
240600585.0,CA de Sophia Antipolis,4248,2491,2614,3242,1603,2219,16417
247000011.0,CA de Vesoul,627,446,442,538,269,386,2708
200068757.0,CA d'Épinal,1911,1430,1560,2030,1028,1727,9686
200069029.0,CA des Deux Baies en Montreuillois,1162,825,891,1338,616,1041,5873
246200299.0,CA d'Hénin-Carvin,2282,1909,2275,3207,1622,2703,13998
200068989.0,CA Dinan Agglomération,1550,1256,1371,1703,829,1361,8070
248300493.0,CA Dracénoise,2245,1683,1731,2054,1087,1391,10191
241500230.0,CA du Bassin d'Aurillac,765,544,599,677,324,508,3417
200071751.0,CA du Bassin de Bourg-en-Bresse,2109,1641,1684,2027,891,1230,9582
200043172.0,CA du Bassin de Brive,1772,1358,1525,1830,909,1470,8864
200066355.0,CA du Bassin de Thau,2884,2164,2228,3047,1519,2443,14285
243301504.0,CA du Bassin Nord,1299,903,952,1205,592,863,5814
200067999.0,CA du Beauvaisis,1983,1572,1702,2218,1127,1680,10282
200040244.0,CA du Bocage Bressuirais,1115,868,898,1165,585,862,5493
246200729.0,CA du Boulonnais,2279,1870,2160,2680,1343,2375,12707
246201149.0,CA du Calaisis,1994,1592,1816,2559,1413,2392,11766
249720061.0,CA du Centre de la Martinique,3561,2922,3386,4314,2247,4810,21240
249730045.0,CA du Centre Littoral,3622,2624,2721,3008,1207,1438,14620
200071678.0,CA du Choletais,1717,1316,1366,1730,914,1512,8555
200067205.0,CA du Cotentin,2525,1828,1616,1891,983,1521,10364
200044618.0,CA du Douaisis (C.A.D.),3025,2500,2918,4124,2016,3363,17946
200034692.0,CA du Gard Rhodanien,1381,1189,1263,1570,776,1184,7363
200071827.0,CA du Grand Angoulême,2599,2143,2258,3058,1551,2406,14015
200066793.0,CA du Grand Annecy,3513,2548,2516,2721,819,955,13072
248400251.0,CA du Grand Avignon (Coga),4848,3692,3943,4726,2151,3414,22774
242500361.0,CA du Grand Besançon,3339,2610,2766,3307,1775,2299,16096
200023737.0,CA du Grand Cahors,917,648,686,855,455,671,4232
200070514.0,CA du Grand Cognac,1111,992,1083,1348,702,1072,6308
244000675.0,CA du Grand Dax,1391,884,917,1135,578,849,5754
200010650.0,CA du Grand Dole,894,694,729,810,393,569,4089
200034825.0,CA du Grand Guéret,427,347,395,480,218,373,2240
248900334.0,CA du Grand Sénonais,1089,946,935,1103,592,795,5460
200049187.0,CA du Grand Verdun,432,353,379,528,281,417,2390
200023307.0,CA du Grand Villeneuvois,941,736,816,986,496,784,4759
200070092.0,CA du Libournais,1782,1538,1602,1915,1042,1687,9566
200041317.0,CA du Niortais,1857,1484,1629,1865,1006,1516,9357
249710062.0,CA du Nord Basse-Terre,1690,1470,1825,2315,1334,2949,11583
200044691.0,CA du Nord Grande Terre,1288,1224,1305,1740,1093,3249,9899
242010056.0,CA du Pays Ajaccien,1803,837,823,996,430,481,5370
200067106.0,CA du Pays Basque,6391,4123,4332,5490,2565,3706,26607
200040277.0,CA du Pays de Dreux,2145,1697,1947,2383,1139,1963,11274
200072346.0,CA du Pays de Fontainebleau,894,716,730,911,404,617,4272
200039857.0,CA du Pays de Grasse,2116,1428,1570,1840,883,1073,8910
200043495.0,CA du Pays de Laon,793,689,765,989,535,1045,4816
243400470.0,CA du Pays de l'Or,1239,933,866,1202,627,827,5694
200072130.0,CA du Pays de Meaux,1814,1452,1725,1837,835,1038,8701
243500782.0,CA du Pays de Saint-Malo - Saint-Malo Agglomération,1630,1114,1162,1485,711,1034,7136
200069037.0,CA du Pays de Saint-Omer,1719,1419,1493,1997,1092,1910,9630
200041788.0,CA du Pays Nord Martinique,2395,1886,2212,2998,1539,3241,14271
243800984.0,CA du Pays Voironnais,1406,1146,1109,1360,571,784,6376
200073419.0,CA du Puy-en-Velay,1184,991,1005,1426,655,1068,6329
200071892.0,CA du Saint-Quentinois,1634,1413,1400,1955,1078,2156,9636
243100633.0,CA du Sicoval,1169,1016,1033,1200,568,827,5813
240200477.0,CA du Soissonnais,980,836,927,1275,641,1363,6022
249740085.0,CA du Sud,3100,2839,4721,5966,3253,7736,27615
245701222.0,CA du Val de Fensch,1252,1021,1151,1421,794,1080,6719
200034700.0,CA Durance-Lubéron-Verdon Agglomération,1387,1031,1080,1455,693,1055,6701
200071116.0,CA Ecla (Espace Communautaire Lons Agglomération),692,450,451,494,236,278,2601
200067684.0,"CA Épernay, Coteaux et Plaine de Champagne",848,659,664,827,471,686,4155
200017846.0,CA Étampois Sud-Essonne,918,712,698,827,319,483,3957
200071454.0,CA Evreux Portes de Normandie,1862,1682,1896,2263,1173,1927,10803
200069821.0,CA Fécamp Caux Littoral Agglomération,649,572,640,836,414,632,3743
200035814.0,CA Flers Agglo,892,667,746,996,493,819,4613
200072452.0,CA Fougères Agglomération,758,683,683,775,356,581,3836
200066124.0,CA Gaillac-Graulhet,1275,1100,1216,1538,785,1171,7085
200067825.0,CA Gap-Tallard-Durance,822,685,778,913,444,595,4237
200067932.0,CA Golfe du Morbihan - Vannes Agglomération,3053,2240,2342,2919,1392,1973,13919
200066926.0,CA Grand Auch Coeur de Gascogne,709,494,496,552,248,363,2862
200069052.0,CA Grand Belfort,1882,1490,1641,1823,994,1384,9214
248600413.0,CA Grand Châtellerault,1394,1107,1257,1498,669,1155,7080
200068674.0,CA Grand Lac - CA du Lac du Bourget,1422,898,905,1154,523,571,5473
248200099.0,CA Grand Montauban,1825,1333,1407,1706,879,1226,8376
200059228.0,CA Grand Paris Sud Seine Essonne Sénart,7105,5081,5734,6193,2674,3374,30161
249710070.0,CA Grand Sud Caraïbe,1641,1496,1961,2724,1616,4219,13657
200067981.0,CA Guingamp-Paimpol Armor-Argoat Agglomération,1235,956,1022,1277,713,1077,6280
200042935.0,CA Haut - Bugey Agglomération,1091,902,909,1102,523,693,5220
247600596.0,CA Havraise (Co.D.A.H.),4776,4070,4277,5510,2851,5146,26630
243400819.0,CA Hérault-Méditerranée,2486,1749,1526,2272,1175,1700,10908
200073096.0,CA Hermitage-Tournonais-Herbasse-Pays de Saint-Félicien,976,816,849,1120,591,882,5234
249740093.0,CA Intercommunale de la Réunion Est (Cirest),3087,2894,4069,4790,2434,5155,22429
249740119.0,CA Intercommunale du Nord de la Réunion (Cinor),4954,4790,6542,8006,4097,7662,36051
200041507.0,CA La Riviera du Levant,1563,1325,1628,2178,1224,3029,10947
248500589.0,CA La Roche-sur-Yon Agglomération,1720,1537,1531,1714,866,1367,8735
200065928.0,CA Lannion-Trégor Communauté,1666,1225,1227,1599,805,1273,7795
247100589.0,CA Le Grand Chalon,1942,1488,1565,2039,1086,1756,9876
241100593.0,CA Le Grand Narbonne,3007,2311,2390,3175,1570,2635,15088
200040392.0,CA Le Grand Périgueux,1915,1520,1483,1869,874,1358,9019
200068641.0,CA Le Muretain Agglo,1985,1664,1851,2113,1083,1615,10311
200071165.0,CA Les Sables d'Olonne Agglomération,1086,697,631,909,441,771,4535
248719312.0,CA Limoges Métropole,3577,2774,3012,3494,1598,2989,17444
200069532.0,CA Lisieux Normandie,1307,987,1059,1300,591,873,6117
200065886.0,CA Loire Forez Agglomération Lfa,1560,1213,1304,1627,824,1119,7647
200042174.0,CA Lorient Agglomération,3630,2963,3189,3737,1732,3103,18354
200040442.0,CA Luberon Monts de Vaucluse,1425,925,1091,1391,664,1111,6607
200070308.0,CA Mâconnais Beaujolais Agglomération,1420,1147,1251,1544,738,986,7086
247700594.0,CA Marne et Gondoire,1561,1174,1344,1576,674,868,7197
200043396.0,CA Maubeuge Val de Sambre,2827,2285,2703,3658,1755,2982,16210
200060010.0,CA Mauges Communauté,1569,1346,1434,1646,890,1317,8202
247700057.0,CA Melun Val de Seine,2783,2061,2183,2484,1137,1376,12024
244500203.0,CA Montargoise et Rives du Loing (A.M.E.),1360,1055,1270,1466,722,1271,7144
244000808.0,CA Mont-de-Marsan Agglomération,978,730,745,914,436,624,4427
200040459.0,CA Montélimar Agglomération,1411,1135,1184,1568,713,982,6993
200071082.0,CA Montluçon Communauté,993,815,927,1226,656,1256,5873
200069425.0,CA Mont-Saint-Michel-Normandie,1287,946,860,1145,562,825,5625
242900835.0,CA Morlaix Communauté,1073,840,948,1165,570,942,5538
200071140.0,CA Moulins Communauté,972,817,893,1142,576,1046,5446
200066009.0,CA Mulhouse Alsace Agglomération,5663,4322,4827,5655,3030,4071,27568
200057958.0,CA Paris - Vallée de la Marne,3876,2819,3266,3594,1548,2218,17321
200067254.0,CA Pau Béarn Pyrénées,3020,2354,2407,3081,1505,2087,14454
200065647.0,CA Pays de Montbéliard Agglomération,2690,2037,2296,2653,1355,2057,13088
200070407.0,CA Pays d'Issoire,904,707,807,1103,593,918,5032
200067791.0,CA Pays Foix-Varilhes,654,500,555,579,271,365,2924
200056380.0,CA Plaine Vallée,2813,2199,2294,2778,1226,1695,13005
200067346.0,CA Pornic Agglo Pays de Retz,1000,826,734,1048,498,738,4844
243800604.0,CA Porte de l'Isère (C.A.P.I),2316,1747,1865,2093,948,1169,10138
245701362.0,CA Portes de France-Thionville,1246,993,1112,1370,674,946,6341
200071413.0,CA Privas Centre Ardèche,745,654,601,877,423,582,3882
200067437.0,CA Provence-Alpes-Agglomération,985,724,818,994,484,762,4767
200068120.0,CA Quimper Bretagne Occidentale,1804,1355,1594,1861,848,1430,8892
242900694.0,CA Quimperlé Communauté,863,733,810,948,450,732,4536
200073344.0,CA Rambouillet Territoires,931,712,690,860,398,538,4129
243500741.0,CA Redon Agglomération,1124,936,1021,1149,585,1005,5820
200070753.0,CA Riom Limagne et Volcans,965,745,724,1007,508,913,4862
200035731.0,CA Roannais Agglomération,1715,1292,1440,1824,924,1567,8762
200041762.0,CA Rochefort Océan,1191,1017,1009,1348,657,1103,6325
241200187.0,CA Rodez Agglomération,870,622,693,764,356,498,3803
200055655.0,CA Roissy Pays de France,7138,5346,6193,7551,3542,4388,34158
241700640.0,CA Royan Atlantique,1969,1193,1222,1584,779,1110,7857
200067502.0,CA Saint-Avold Synergie,831,694,800,1091,508,799,4723
200069409.0,CA Saint-Brieuc Armor Agglomération,2659,2142,2247,2789,1338,2230,13405
200058519.0,CA Saint-Germain Boucles de Seine,4429,3323,3610,4341,2082,2972,20757
200066389.0,CA Saint-Lô Agglo,1165,956,902,1111,548,790,5472
200066058.0,CA Saint-Louis Agglomération,1316,814,987,1255,628,723,5723
200070746.0,CA Sarreguemines Confluences,1025,759,911,1096,618,906,5315
200071876.0,CA Saumur Val de Loire,1939,1447,1625,1958,1002,1984,9955
200035665.0,CA Seine Eure,1214,1056,1145,1458,760,1379,7012
200072312.0,CA Seine Normandie Agglomération,1395,1082,1203,1523,759,1284,7246
248300394.0,CA Sud Sainte-Baume,1214,786,856,1011,468,661,4996
200069300.0,CA Tarbes-Lourdes-Pyrénées,4001,1875,2032,2489,1189,1808,13394
200035087.0,CA Terre de Provence,1290,868,932,1206,603,842,5741
249740101.0,CA Territoire de la Côte Ouest (Tco),5760,5128,6725,8873,5158,11397,43041
200072072.0,CA Territoires Vendômois,705,610,669,882,489,794,4149
200067551.0,CA Thonon Agglomération,1738,1257,1243,1320,571,639,6768
200069250.0,CA Troyes Champagne Métropole,3525,2761,3196,3958,2114,3058,18612
241927201.0,CA Tulle Agglo,617,458,541,629,302,444,2991
200030674.0,CA Val de Garonne Agglomération,1177,874,886,1147,552,947,5583
247700339.0,CA Val d'Europe Agglomération,496,391,417,509,226,285,2324
200058477.0,CA Val d'Yerres Val de Seine,2826,2244,2229,2642,1158,1557,12656
200058485.0,CA Val Parisis,4072,3245,3608,4162,1970,2873,19930
200068781.0,CA Valence Romans Agglo,4247,3582,3955,4792,2318,3597,22491
245901160.0,CA Valenciennes Métropole,3935,3150,3593,5049,2424,3768,21919
200035319.0,CA Var Esterel Méditerranée (Cavem),3119,1973,1733,2351,1248,1353,11777
248400053.0,CA Ventoux-Comtat-Venaissin (Cove),1730,1214,1361,1689,795,1321,8110
247800584.0,CA Versailles Grand Parc (C.A.V.G.P.),2919,2287,2246,2820,1292,1803,13367
200071363.0,CA Vichy Communauté,1440,1095,1225,1560,809,1613,7742
200077014.0,CA Vienne Condrieu,1468,1156,1161,1364,590,823,6562
200040590.0,CA Villefranche Beaujolais Saône,1364,1012,1119,1399,591,913,6398
200039022.0,CA Vitré Communauté,1153,999,1097,1148,594,785,5776
200072106.0,CC Adour Madiran,407,266,386,449,203,252,1963
246600423.0,CC Agly Fenouillèdes,114,93,96,120,96,146,665
200041416.0,CC Airvaudais-Val du Thouet,94,64,77,102,42,93,472
200068948.0,CC Albret Communauté,423,341,370,474,253,463,2324
200039931.0,CC Alpes d'Azur,155,86,122,152,82,93,690
200068625.0,"CC Alpes-Provence-Verdon ""sources de Lumière""",263,144,166,193,139,189,1094
242504488.0,CC Altitude 800,87,44,68,63,39,40,341
200070761.0,CC Ambert Livradois Forez,348,259,356,404,236,369,1972
200067908.0,CC Amognes Coeur du Nivernais,101,77,82,112,55,73,500
200068443.0,CC Andaine - Passais,232,133,135,168,89,131,888
244900809.0,CC Anjou Bleu Communauté,623,470,527,566,200,336,2722
200068955.0,CC Anjou Loir et Sarthe,396,325,386,505,243,504,2359
200071595.0,"CC Arbois, Poligny, Salins, Coeur du Jura",268,227,219,268,128,195,1305
200027027.0,CC Arc Sud Bretagne,405,338,344,441,219,337,2084
200039824.0,CC Ardèche des Sources et Volcans,220,131,138,224,117,194,1024
200071405.0,CC Ardèche Rhône Coiron,461,371,403,511,217,364,2327
240800821.0,"CC Ardenne, Rives de Meuse",411,381,456,611,359,495,2713
200041622.0,CC Ardennes Thiérache,131,106,119,140,86,129,711
200068450.0,CC Argentan Intercom,520,441,485,503,227,365,2541
200066116.0,CC Argonne-Meuse,91,60,67,90,38,81,427
200066223.0,CC Arize Lèze,203,158,177,233,124,172,1067
200035632.0,CC Armagnac Adour,90,69,79,96,56,78,468
200027076.0,CC Arnon Boischaut Cher,109,100,83,133,70,123,618
243200607.0,CC Artagnan de Fezensac,96,56,72,100,36,56,416
247400583.0,CC Arve et Salève,292,238,228,281,111,87,1237
200035756.0,CC Astarac Arros en Gascogne,85,65,68,95,46,66,425
243500634.0,CC Au Pays de la Roche aux Fées,360,272,288,338,184,297,1739
200069268.0,CC Aubrac Lot Causses Tarn,106,61,89,113,41,41,451
200067171.0,"CC Aubrac, Carladez et Viadène",97,60,63,74,44,58,396
200041499.0,CC Aunis Atlantique,477,446,443,540,245,340,2491
200041614.0,CC Aunis Sud,499,464,465,624,288,464,2804
200043123.0,CC Auray Quiberon Terre Atlantique,1824,1185,1196,1613,787,1246,7851
246500573.0,CC Aure-Louron,169,97,184,137,87,123,797
200070902.0,CC Auxonne Pontailler Val de Saône,304,233,274,367,204,339,1721
244301099.0,CC Auzon Communauté,140,115,123,225,76,152,831
200039758.0,"CC Avallon, Vézelay, Morvan",296,203,229,281,162,171,1342
241200807.0,CC Aveyron Bas Ségala Viaur,58,55,69,75,44,50,351
200070969.0,CC Avre Luce Noye,344,232,251,349,213,320,1709
248400160.0,CC Aygues-Ouvèze en Provence (Ccaop),342,309,289,377,181,267,1765
200040251.0,CC Bassée-Montois,310,269,300,367,145,211,1602
200034726.0,CC Bastides de Lomagne,152,100,130,142,71,112,707
243200508.0,CC Bastides et Vallons du Gers,99,76,76,99,45,88,483
244900882.0,CC Baugeois Vallée,531,439,459,604,297,541,2871
200067882.0,CC Bazois Loire Morvan,175,132,113,189,114,182,905
243000585.0,CC Beaucaire Terre d'Argence,999,711,654,911,488,762,4525
200055481.0,CC Beauce Val de Loire,294,212,251,304,172,262,1495
200040574.0,CC Beaujolais Pierres Dorées,610,487,476,555,230,325,2683
240700815.0,CC Berg et Coiron,149,131,130,152,78,132,772
200049484.0,CC Berry Grand Sud,160,130,127,205,104,179,905
200068278.0,CC Berry Loire Puisaye,298,269,261,340,156,339,1663
200032514.0,CC Berry-Loire-Vauvise,79,59,75,88,51,106,458
200059392.0,CC Bièvre Isère,815,682,660,884,397,522,3960
200067627.0,CC Billom Communauté,320,242,312,437,196,336,1843
241400878.0,CC Blangy-Pont-l'Evêque Intercom,318,202,183,280,126,174,1283
200067486.0,CC Bouzonvillois-Trois Frontières,255,224,218,326,147,245,1415
243600319.0,CC Brenne - Val de Creuse,262,165,206,261,116,177,1187
200071371.0,CC Bresse et Saône,318,283,276,329,165,215,1586
200069615.0,CC Bresse Haute Seille,259,193,184,212,108,124,1080
200071579.0,CC Bresse Louhannaise Intercom',438,345,348,442,197,218,1988
247100647.0,CC Bresse Nord Intercom,72,54,66,96,42,70,400
200042414.0,CC Bresse Revermont 71,136,98,115,118,56,86,609
200070662.0,CC Bretagne Porte de Loire Communauté,444,350,372,492,199,362,2219
243500733.0,CC Bretagne Romantique,500,411,443,557,285,443,2639
248719338.0,CC Briance Combade,53,36,55,84,50,64,342
200040814.0,CC Briance Sud Haute Vienne,99,97,73,125,60,117,571
200070779.0,CC Brie des Rivières et Châteaux,432,327,367,418,201,245,1990
247700701.0,CC Brie Nangissienne,399,314,376,418,186,224,1917
244301032.0,CC Brioude Sud Auvergne,313,211,232,342,179,245,1522
200042000.0,CC Bruyères-Vallons des Vosges,207,168,194,247,125,263,1204
200067445.0,CC Buëch-Dévoluy,158,125,149,179,84,130,825
200040350.0,CC Bugey Sud,540,419,470,553,255,357,2594
200073146.0,CC Cagire Garonne Salat,272,226,230,310,141,287,1466
247600505.0,CC Campagne-De-Caux,158,143,156,231,128,195,1011
200067676.0,CC Canaux et Forêts en Gâtinais,417,316,378,414,219,451,2195
242900629.0,CC Cap Sizun - Pointe du Raz,249,147,166,242,94,200,1098
200040905.0,CC Carmausin-Ségala,547,421,425,579,285,396,2653
200073013.0,CC Carnelle Pays-De-France,341,305,282,377,164,219,1688
200035855.0,CC Castelnaudary Lauragais Audois,520,409,410,476,210,361,2386
243301454.0,CC Castillon/Pujols,369,327,327,424,252,345,2044
200034601.0,CC Causses Aigoual Cévennes,117,93,103,134,54,99,600
200066371.0,CC Causses et Vallée de la Dordogne,889,594,633,768,408,595,3887
247600646.0,CC Caux - Austreberthe,394,357,367,437,237,419,2211
247600539.0,CC Caux Estuaire,175,162,170,245,122,203,1077
200035327.0,CC Cazals-Salviac,80,61,51,78,51,76,397
242000503.0,CC Celavu-Prunelli,196,78,83,125,42,58,582
200067221.0,CC Centre Morbihan Communauté,587,522,545,695,338,515,3202
200034049.0,CC Centre Tarn,160,132,141,183,89,129,834
241501089.0,CC Cère et Goul en Carladès,52,49,48,64,32,61,306
200067080.0,"CC Chablis, Villages et Terroirs",195,140,132,210,102,167,946
243600202.0,CC Chabris - Pays de Bazelle,84,66,58,92,45,90,435
200071629.0,CC Challans-Gois Communauté,808,616,674,864,426,606,3994
200069649.0,CC Chalosse Tursan,346,275,292,398,203,332,1846
200068880.0,CC Champagne Boischauts,127,99,122,173,76,116,713
200069623.0,CC Champagnole Nozeroy Jura,303,237,262,279,148,159,1388
200068096.0,CC Champsaur-Valgaudemar,156,116,195,185,118,186,956
241700517.0,CC Charente-Arnoult-Coeur de Saintonge,267,208,229,316,127,231,1378
200035202.0,CC Charlieu-Belmont,276,236,267,346,192,320,1637
200072726.0,CC Châteaubriant-Derval,699,557,557,693,339,609,3454
200071215.0,CC Chavanon Combrailles et Volcans,135,98,134,158,81,159,765
200067593.0,"CC Chénérailles, Auzances/Bellegarde et Haut Pays Marchois",187,127,160,210,94,164,942
200043081.0,"CC Chinon, Vienne et Loire",428,316,323,417,207,374,2065
200066710.0,CC Cingal-Suisse Normande,322,315,297,400,225,277,1836
200033116.0,CC Cluses-Arve et Montagnes,1029,755,861,863,422,569,4499
241400415.0,CC Coeur Côte Fleurie,456,309,300,391,201,313,1970
243200425.0,CC Coeur d'Astarac en Gascogne,136,109,107,87,55,86,580
200070159.0,CC Coeur de Beauce,356,250,287,374,183,287,1737
200070571.0,CC Coeur de Berry,242,200,229,287,150,237,1345
243600343.0,CC Coeur de Brenne,48,51,43,77,26,71,316
200072023.0,CC Coeur de Charente,294,266,273,385,190,289,1697
200040111.0,CC Coeur de Chartreuse,241,170,189,245,118,148,1111
200036135.0,CC Coeur de France,281,209,268,289,163,348,1558
200068815.0,CC Coeur de Garonne,497,448,486,602,302,510,2845
200043263.0,CC Coeur de l'Avesnois,537,442,485,676,344,634,3118
244800405.0,CC Coeur de Lozère,225,180,159,203,80,100,947
200070464.0,CC Coeur de Maurienne Arvan,256,177,197,195,102,101,1028
241400860.0,CC Coeur de Nacre,338,286,290,370,207,313,1804
200041010.0,CC Coeur de Savoie,566,390,442,539,238,306,2481
200000800.0,CC Coeur de Sologne,152,112,131,151,72,157,775
200023299.0,CC Coeur de Tarentaise,259,103,159,127,23,48,719
245901152.0,CC Coeur d'Ostrevent [C.C.C.O.],1357,1186,1304,1797,866,1498,8008
200068435.0,CC Coeur du Perche,135,123,129,180,96,129,792
248300550.0,CC Coeur du Var,845,665,666,842,397,568,3983
247800618.0,CC Coeur d'Yvelines,465,381,402,494,242,301,2285
200072643.0,CC Coeur et Coteaux du Comminges,692,585,583,730,377,586,3553
200069656.0,CC Coeur Haute Lande,361,235,267,357,178,268,1666
200072098.0,CC Combrailles Sioule et Morge,224,194,212,292,161,236,1319
200071512.0,CC Commentry Montmarault Néris Communauté,375,285,313,448,207,456,2084
200070068.0,CC Communauté Bray-Eawy,309,242,268,361,201,320,1701
242900793.0,CC Communauté Lesneven Côte des Légendes,358,292,347,418,256,373,2044
200067478.0,CC Comtal Lot et Truyère,202,144,169,208,95,141,959
200049211.0,CC Conflent-Canigó,516,347,377,516,274,365,2395
241200641.0,CC Conques-Marcillac,138,117,111,141,79,98,684
200069581.0,CC Convergence Garonne,549,454,478,586,297,518,2882
200070365.0,CC Corbières Salanque Méditerranée,436,385,380,514,253,400,2368
243500725.0,CC Côte d'Émeraude,552,427,405,496,256,385,2521
244000857.0,CC Côte Landes Nature,332,192,184,215,117,159,1199
200067031.0,CC Côte Ouest Centre Manche,293,258,274,337,174,262,1598
200067122.0,CC Coteaux et Plaines du Pays Lafrançaisain,173,128,160,210,114,153,938
244000881.0,CC Coteaux et Vallées des Luys,80,85,95,115,67,81,523
200067379.0,CC Côtes de Champagne et Val de Saulx,210,136,156,185,97,143,927
200034874.0,CC Côtes de Meuse Woëvre,73,56,72,95,42,83,421
200070688.0,CC Couesnon Marches de Bretagne,282,211,237,280,130,251,1391
200067940.0,CC Couserans-Pyrénées,575,511,523,751,357,528,3245
200067023.0,CC Coutances Mer et Bocage,753,591,498,665,340,500,3347
200067544.0,CC Creuse Confluence,250,140,199,264,123,230,1206
200044014.0,CC Creuse Grand Sud,180,161,146,248,107,238,1080
200067189.0,CC Creuse Sud Ouest,169,157,168,212,121,202,1029
200030435.0,CC d'Aire-sur-l'Adour,205,168,147,196,78,126,920
200071777.0,"CC d'Arcis, Mailly, Ramerupt",164,150,158,172,128,167,939
200027308.0,CC d'Auberive Vingeanne et Montsaugeonnais,124,85,100,100,63,72,544
241400555.0,CC de Bayeux Intercom,622,371,373,492,229,335,2422
245600465.0,CC de Belle-Ile-en-Mer,208,76,65,101,56,81,587
243801073.0,CC de Bièvre Est,285,253,244,318,159,195,1454
245600440.0,CC de Blavet Bellevue Océan,230,221,204,270,122,225,1272
200023794.0,CC de Blaye,398,329,345,466,249,368,2155
243700820.0,CC de Bléré Val de Cher,353,228,256,346,174,249,1606
243500618.0,CC de Brocéliande,253,208,212,262,147,227,1309
242020105.0,CC de Calvi Balagne,1040,216,93,148,58,44,1599
245700695.0,CC de Cattenom et Environs,225,195,208,285,113,150,1176
200035129.0,CC de Cèze Cévennes,404,347,368,510,229,416,2274
200072049.0,CC de Charente Limousine,484,418,438,527,275,466,2608
200066157.0,CC de Commercy - Void - Vaucouleurs,365,291,331,385,218,350,1940
200066173.0,CC de Damvillers Spincourt,103,85,75,135,58,90,546
200018083.0,CC de Desvres-Samer,300,239,275,377,228,342,1761
200041440.0,CC de Domme - Villefranche du Périgord,224,111,103,133,67,118,756
200033827.0,CC de Fium'orbu Castellu,397,191,168,176,91,90,1113
200040947.0,CC de Flandre Intérieure,1319,1119,1159,1496,763,1064,6920
200065894.0,CC de Forez-Est,757,616,670,774,439,545,3801
245700398.0,CC de Freyming-Merlebach,644,529,536,734,404,554,3401
200073237.0,CC de Gâtine et Choisilles - Pays de Racan,292,244,246,306,151,280,1519
241700632.0,CC de Gémozac et de la Saintonge Viticole,241,192,220,302,161,223,1339
200070894.0,CC de Gevrey-Chambertin et de Nuits-Saint-Georges,350,293,278,386,182,267,1756
244400438.0,CC de Grand Lieu,535,425,475,591,261,403,2690
200042604.0,"CC de Granville, Terre et Mer",706,547,538,736,369,512,3408
200067783.0,CC de Hanau-la Petite Pierre,373,266,240,335,203,285,1702
242900561.0,CC de Haute-Cornouaille,222,162,222,232,117,215,1170
247300254.0,CC de Haute-Tarentaise,324,197,364,214,81,73,1253
200042729.0,CC de la Baie du Cotentin,360,305,292,394,159,257,1767
246700843.0,CC de la Basse-Zorn,161,121,148,171,90,144,835
200035764.0,CC de la Beauce Loirétaine,205,159,175,197,110,206,1052
245100888.0,CC de la Brie Champenoise,100,74,107,118,67,71,537
200073252.0,CC de la Castagniccia-Casinca,316,188,165,175,77,80,1001
200072718.0,CC de la Champagne Conlinoise et du Pays de Sillé,239,193,216,300,167,293,1408
240200576.0,CC de la Champagne Picarde,247,280,267,399,224,414,1831
200066678.0,CC de la Châtaigneraie Cantalienne,253,164,195,202,105,155,1074
243600350.0,CC de la Châtre et Sainte-Sévère,183,172,190,259,136,217,1157
200067668.0,"CC de la Cléry, du Betz et de l'Ouanne",307,230,326,369,185,304,1721
200034205.0,CC de la Costa Verde,293,157,122,137,65,62,836
200069839.0,CC de la Côte d'Albâtre,362,280,334,510,282,469,2237
240100610.0,CC de la Côtière à Montluel,358,277,277,329,170,163,1574
200069193.0,CC de la Dombes,517,350,394,465,225,226,2177
244500484.0,CC de la Forêt,200,170,156,230,99,205,1060
200023620.0,CC de la Gascogne Toulousaine,283,207,194,272,125,200,1281
245100615.0,CC de la Grande Vallée de la Marne,140,132,163,214,97,185,931
200066363.0,CC de la Haute Ariège,139,99,133,147,69,94,681
200041721.0,CC de la Haute Comté,262,227,231,312,140,245,1417
200037059.0,CC de la Haute Somme (Combles - Péronne - Roisel),514,335,447,678,335,717,3026
200033173.0,CC de la Haute Vallée de Chevreuse,236,164,190,227,94,140,1051
247000854.0,CC de la Haute Vallée de l'Ognon,114,106,99,148,74,130,671
246500482.0,CC de la Haute-Bigorre,320,194,234,341,180,299,1568
245901061.0,CC de la Haute-Deûle,313,278,296,400,179,387,1853
200041523.0,CC de la Haute-Saintonge,1100,921,1032,1259,686,1049,6047
243200391.0,CC de la Lomagne Gersoise,298,230,224,327,158,209,1446
248200065.0,CC de la Lomagne Tarn-et-Garonnaise,196,123,121,165,80,96,781
200007052.0,CC de la Marche Berrichonne,60,49,49,77,38,59,332
200040657.0,CC de la Matheysine,288,190,217,254,135,198,1282
200043438.0,CC de la Moivre à la Coole,106,72,66,102,47,78,471
200072007.0,CC de la Montagne d'Ardèche,60,35,21,50,31,58,255
200042463.0,CC de la Montagne Noire,96,88,76,130,64,108,562
200068864.0,CC de la Mossig et du Vignoble,264,255,264,283,167,230,1463
241200914.0,CC de la Muse et des Raspes du Tarn,67,52,64,90,31,44,348
246000848.0,CC de la Picardie Verte,486,384,440,559,338,476,2683
200038958.0,CC de la Pieve de l'Ornano,379,137,120,165,63,74,938
240100883.0,CC de la Plaine de l'Ain,1345,997,1079,1213,547,621,5802
246000897.0,CC de la Plaine d'Estrées,200,153,186,256,163,205,1163
200000925.0,CC de la Plaine Dijonnaise,278,222,209,260,150,274,1393
244500542.0,CC de la Plaine du Nord Loiret,85,83,80,101,49,68,466
200041283.0,CC de la Plaine du Rhin,167,141,144,188,101,169,910
243901089.0,CC de la Plaine Jurassienne,114,80,96,115,50,101,556
200068377.0,CC de la Porte des Vosges Méridionales,451,379,432,531,301,511,2605
246200844.0,CC de la Région d'Audruicq,399,326,345,499,252,397,2218
241000405.0,CC de la Région de Bar-sur-Aube,194,144,177,217,113,190,1035
244400453.0,CC de la Région de Blain,240,211,214,255,123,209,1252
246800569.0,CC de la Région de Guebwiller,625,445,530,648,312,466,3026
243600293.0,CC de la Région de Levroux,81,64,77,101,55,81,459
246701064.0,CC de la Région de Molsheim-Mutzig,501,432,471,585,266,383,2638
200005957.0,CC de la Région de Rambervillers,198,145,170,248,114,231,1106
200042620.0,CC de la Région de Suippes,73,79,83,93,56,69,453
243901071.0,CC de la Région d'Orgelet,86,57,63,67,31,34,338
247600620.0,CC de la Région d'Yvetot,378,317,367,423,233,398,2116
243100781.0,CC de la Save au Touch,636,554,534,575,304,412,3015
244100780.0,CC de la Sologne des Étangs,108,90,112,118,55,107,590
244100806.0,CC de la Sologne des Rivières,123,109,138,184,105,163,822
243900354.0,CC de la Station des Rousses-Haut Jura,138,94,99,109,71,60,571
243200417.0,CC de la Tenarèze,241,215,202,246,119,201,1224
246200380.0,CC de la Terre des Deux Caps,323,273,268,424,207,383,1878
240200444.0,CC de la Thiérache du Centre,451,395,375,577,260,497,2555
200023372.0,CC de la Vallée de Chamonix-Mont-Blanc,371,185,229,167,81,83,1116
246800551.0,CC de la Vallée de Kaysersberg,202,140,162,194,117,159,974
246700306.0,CC de la Vallée de la Bruche,272,213,240,316,182,289,1512
246800676.0,CC de la Vallée de la Doller et du Soultzbach,207,149,183,216,121,125,1001
200035103.0,CC de la Vallée de la Haute-Sarthe,99,78,91,101,62,78,509
200041168.0,CC de la Vallée de l'Homme,399,194,202,287,149,177,1408
249500455.0,CC de la Vallée de l'Oise et des Trois Forêts,469,371,397,477,221,315,2250
246800585.0,CC de la Vallée de Munster,211,128,146,194,104,184,967
246800205.0,CC de la Vallée de Saint-Amarin,188,122,164,185,92,131,882
246700777.0,CC de la Vallée de Villé,107,97,102,133,63,99,601
246400337.0,CC de la Vallée d'Ossau,160,113,148,158,89,133,801
248300410.0,CC de la Vallée du Gapeau,512,401,349,454,192,299,2207
246900757.0,CC de la Vallée du Garon (Ccvg),381,298,333,395,174,215,1796
244600433.0,CC de la Vallée du Lot et du Vignoble,229,185,209,245,130,224,1222
247400047.0,CC de la Vallée Verte,123,87,100,103,53,39,505
248900664.0,CC de la Vanne et du Pays d'Othe,127,107,114,141,85,97,671
200070555.0,CC de la Veyle,283,208,269,286,158,187,1391
200039204.0,CC de Lacq-Orthez,868,622,657,859,456,708,4170
248900383.0,CC de l'Agglomération Migennoise,301,195,257,314,140,205,1412
248900524.0,CC de l'Aillantais,129,99,124,130,53,110,645
200066140.0,CC de l'Aire à l'Argonne,73,52,57,72,45,66,365
246000764.0,CC de l'Aire Cantilienne,546,424,454,577,285,410,2696
200067841.0,CC de l'Alsace Bossue,337,238,295,344,166,311,1691
242000495.0,CC de l'Alta Rocca,395,100,92,84,29,28,728
245701354.0,CC de l'Arc Mosellan,394,298,319,407,224,292,1934
240800920.0,CC de l'Argonne Ardennaise,230,159,176,223,127,162,1077
200042703.0,CC de l'Argonne Champenoise,148,137,135,170,112,139,841
245300355.0,CC de l'Ernée,263,167,184,217,128,148,1107
200070985.0,CC de l'Est de la Somme,382,291,328,500,251,502,2254
249730052.0,CC de l'Est Guyanais,163,158,154,192,92,112,871
246900575.0,CC de l'Est Lyonnais (Ccel),447,384,357,445,215,310,2158
243300811.0,CC de l'Estuaire - Canton de Saint-Ciers-sur-Gironde,307,285,258,405,198,305,1758
241200765.0,CC de Lévézou Pareloup,35,31,31,58,21,37,213
248500191.0,CC de l'Ile de Noirmoutier,252,139,103,173,97,126,890
241700459.0,CC de l'Ile de Ré,594,236,216,336,149,235,1766
241700624.0,CC de l'Ile d'Oléron,788,446,322,448,217,298,2519
200073104.0,CC de l'Ile-Rousse - Balagne,637,128,82,140,41,41,1069
243800745.0,CC de l'Oisans,215,154,254,229,117,103,1072
200068005.0,CC de l'Oise Picarde,332,250,304,376,230,357,1849
247600604.0,CC de Londinières,60,55,57,91,59,81,403
200015162.0,CC de l'Oriente,162,58,77,82,21,37,437
241000488.0,CC de l'Orvin et de l'Ardusson,121,99,116,151,75,110,672
249730037.0,CC de l'Ouest Guyanais,1352,1110,1254,1238,535,595,6084
200068559.0,CC de l'Ouest Vosgien,345,257,297,370,196,382,1847
200066785.0,CC de l'Oust à Brocéliande Communauté,513,479,484,581,295,411,2763
200040178.0,CC de l'Outre-Forêt,184,157,162,227,126,155,1011
200036499.0,CC de Marana-Golo,602,351,283,322,129,147,1834
247100639.0,CC de Marcigny,81,60,57,78,34,73,383
249710047.0,CC de Marie-Galante,254,237,250,336,171,306,1554
241200567.0,CC de Millau Grands Causses,643,484,464,627,283,384,2885
244000543.0,CC de Mimizan,310,197,176,284,162,196,1325
200068369.0,CC de Mirecourt Dompaire,250,182,177,275,135,272,1291
240100800.0,CC de Miribel et du Plateau,324,266,245,301,126,173,1435
200034197.0,CC de Montaigne Montravel et Gurson,226,175,171,233,130,187,1122
242500320.0,CC de Montbenoît,92,78,75,81,42,51,419
243301264.0,CC de Montesquieu,560,502,468,602,305,401,2838
248719361.0,CC de Noblat,131,105,138,165,85,167,791
244400537.0,CC de Nozay,222,184,165,248,123,202,1144
200041333.0,CC de Parthenay-Gâtine,509,446,467,605,302,549,2878
243000593.0,CC de Petite Camargue,650,554,520,622,336,469,3151
200065787.0,CC de Pont-Audemer / Val de Risle,457,418,394,533,246,445,2493
200040889.0,CC de Portes Sud Périgord,139,123,102,139,61,102,666
200071207.0,CC de Pouilly-en-Auxois/Bligny-sur-Ouche,118,70,93,121,50,100,552
200067130.0,CC de Puisaye-Forterre,453,361,341,493,245,405,2298
247200090.0,CC de Sablé-sur-Sarthe,496,415,440,561,295,475,2682
200066660.0,CC de Saint-Flour,324,191,213,250,90,130,1198
200038990.0,CC de Saint-Méen Montauban,338,299,297,327,188,263,1712
242101442.0,CC de Saulieu,71,60,53,75,42,85,386
200070589.0,CC de Seille et Grand Couronné,197,171,160,226,127,183,1064
246700967.0,CC de Sélestat,648,424,583,663,335,494,3147
200066835.0,CC de Sézanne-Sud Ouest Marnais,299,244,290,347,186,252,1618
200036465.0,CC de Thann-Cernay,600,453,511,653,299,464,2980
200066892.0,CC de Vendeuvre-Soulaines,143,90,101,126,87,129,676
241900133.0,CC de Ventadour - Egletons - Monédières,146,98,111,151,64,114,684
200069433.0,CC de Vezouze en Piémont,159,133,139,209,113,253,1006
200072882.0,CC de Vie et Boulogne,680,585,565,661,342,471,3304
200043354.0,CC de Villedieu Intercom,209,176,184,211,107,188,1075
200034718.0,"CC de Vitry, Champagne et Der",415,314,345,476,264,399,2213
247300262.0,CC de Yenne,107,77,83,100,55,64,486
200067064.0,CC Decazeville Communauté,326,241,234,287,129,171,1388
244400503.0,CC d'Erdre et Gesvres,811,645,691,831,387,567,3932
200029734.0,CC des 4B Sud Charente,299,238,268,335,151,303,1594
200043602.0,"CC des Albères, de la Côte Vermeille et de l'Illibéris",1804,1120,958,1445,743,1026,7096
246600449.0,CC des Aspres,490,418,383,551,256,442,2540
200033868.0,CC des Ballons des Hautes-Vosges,218,164,206,282,136,292,1298
200068229.0,CC des Baronnies en Drôme Provençale,459,319,325,497,253,408,2261
200034833.0,CC des Bastides Dordogne-Périgord,294,224,208,290,161,243,1420
200036523.0,CC des Bastides en Haut-Agenais Périgord,249,203,198,266,148,227,1291
200069482.0,CC des Campagnes de l'Artois,377,297,359,501,262,365,2161
200068484.0,CC des Causses à l'Aubrac,177,133,124,151,82,122,789
200069136.0,CC des Cévennes Au Mont Lozère,78,61,74,82,32,72,399
243400736.0,CC des Cévennes Gangeoises et Suménoises,286,268,270,338,153,234,1549
200033298.0,CC des Coëvrons,322,250,305,382,189,276,1724
243801255.0,CC des Collines du Nord Dauphiné,335,261,232,281,145,157,1411
244100293.0,CC des Collines du Perche,77,67,67,78,36,79,404
200071504.0,CC des Collines du Perche Normand,151,141,155,178,116,144,885
247000367.0,CC des Combes,83,85,89,83,44,73,457
200042372.0,CC des Coteaux Arrats Gimone,170,104,114,140,71,107,706
243100815.0,CC des Coteaux Bellevue,230,206,247,243,103,182,1211
243301355.0,CC des Coteaux Bordelais,285,222,237,292,143,195,1374
243100732.0,CC des Coteaux du Girou,270,247,254,252,146,237,1406
200070803.0,CC des Coteaux du Val-d'Arros,152,104,143,155,55,87,696
244701355.0,CC des Coteaux et Landes de Gascogne,177,148,166,237,116,167,1011
240800862.0,CC des Crêtes Préardennaises,288,208,272,332,156,297,1553
200072544.0,CC des Deux Morin,404,306,294,434,205,267,1910
248200016.0,CC des Deux Rives,368,307,318,383,190,256,1822
246000772.0,CC des Deux Vallées,331,274,316,405,220,391,1937
249100157.0,CC des Deux Vallées,208,137,153,207,82,117,904
200068294.0,CC des Deux Vallées Vertes,199,167,179,251,125,175,1096
200069912.0,CC des Forêts du Perche,117,79,93,147,72,125,633
200039808.0,CC des Gorges de l'Ardèche,475,333,243,486,258,354,2149
244000873.0,CC des Grands Lacs,752,522,480,690,332,413,3189
200069144.0,CC des Hautes Terres de l'Aubrac,62,35,25,44,14,32,212
200071157.0,CC des Hautes-Vosges,603,413,402,572,290,507,2787
200040954.0,CC des Hauts de Flandre,635,571,595,807,396,698,3702
200068856.0,CC des Hauts du Perche,105,104,119,139,58,77,602
200036150.0,CC des Hauts du Val de Saône,136,88,102,130,51,79,586
200040137.0,CC des Lacs de Champagne,150,100,98,128,74,140,690
200069565.0,CC des Lacs et Montagnes du Haut-Doubs,291,191,202,225,109,108,1126
200035541.0,CC des Landes d'Armagnac,156,122,148,187,80,123,816
246000749.0,CC des Lisières de l'Oise,191,174,199,228,130,235,1157
244500427.0,CC des Loges,512,454,496,563,285,495,2805
200067239.0,CC des Luys en Béarn,379,308,326,403,218,261,1895
200034098.0,CC des Montagnes du Giffre,201,133,196,206,100,112,948
200034031.0,CC des Monts d'Alban et du Villefranchois,72,76,72,83,43,53,399
247000698.0,CC des Monts de Gy,103,70,62,76,38,78,427
200066553.0,CC des Monts de Lacaune et de la Montagne du Haut Languedoc,110,92,72,97,61,90,522
200066587.0,CC des Monts du Lyonnais,364,282,311,428,192,284,1861
244200622.0,CC des Monts du Pilat,176,123,154,208,98,166,925
244301123.0,CC des Pays de Cayres et de Pradelles,60,50,48,61,37,54,310
200068468.0,CC des Pays de l'Aigle,406,331,392,475,197,298,2099
246000921.0,CC des Pays d'Oise et d'Halatte,495,446,472,610,307,426,2756
245400189.0,CC des Pays du Sel et du Vermois,350,310,300,418,231,414,2023
200066850.0,CC des Paysages de la Champagne,258,210,234,303,135,223,1363
200066231.0,CC des Portes d'Ariège Pyrénées,875,696,705,747,324,509,3856
240200634.0,CC des Portes de la Thiérache,98,71,103,141,87,204,704
243301439.0,CC des Portes de l'Entre-deux-Mers,262,257,223,330,166,292,1530
200000545.0,CC des Portes de Romilly-sur-Seine,483,355,436,452,267,365,2358
246700744.0,CC des Portes de Rosheim,201,157,185,214,110,182,1049
200005932.0,CC des Portes de Sologne,170,179,170,189,120,159,987
248719353.0,CC des Portes de Vassivière,61,57,77,80,45,78,398
242504181.0,CC des Portes du Haut-Doubs,317,209,246,326,129,141,1368
240800847.0,CC des Portes du Luxembourg,307,261,288,402,199,339,1796
200069953.0,CC des Portes Euréliennes d'Ile-de-France,659,496,550,704,351,536,3296
200069730.0,CC des Quatre Rivières,394,346,357,525,263,452,2337
247000623.0,CC des Quatre Rivières,125,79,115,128,69,83,599
247400666.0,CC des Quatre Rivières,290,191,237,261,105,121,1205
244500419.0,CC des Quatre Vallées,219,201,236,289,155,228,1328
200073393.0,CC des Rives du Haut-Allier,227,171,204,261,114,208,1185
246000582.0,CC des Sablons,572,501,550,731,331,454,3139
200027548.0,CC des Savanes,966,710,670,770,261,367,3744
200044030.0,CC des Sept Vallées,444,363,406,554,302,405,2474
248400293.0,CC des Sorgues du Comtat,1118,805,907,1181,550,830,5391
200035111.0,CC des Sources de l'Orne,151,126,144,185,77,114,797
247400773.0,CC des Sources du Lac d'Annecy,290,161,226,214,107,122,1120
244301016.0,CC des Sucs,247,202,238,265,135,208,1295
200069185.0,CC des Terres d'Apcher-Margeride-Aubrac,117,76,79,102,45,75,494
200071017.0,CC des Terres d'Auxois,228,151,185,198,117,204,1083
200071298.0,CC des Terres du Lauragais,539,452,466,562,303,471,2793
200070183.0,CC des Terres du Val de Loire,663,533,595,669,351,594,3405
245200597.0,CC des Trois Forêts,83,71,75,90,50,66,435
240200600.0,CC des Trois Rivières,365,325,380,506,249,429,2254
247300015.0,CC des Vallées d'Aigueblanche,219,82,86,66,19,31,503
200069458.0,CC des Vallées d'Auge et du Merlerault,241,180,191,223,118,180,1133
200072692.0,CC des Vallées de la Braye et de l'Anille,219,159,190,234,100,206,1108
242100154.0,CC des Vallées de la Tille et de l'Ignon,149,135,114,191,96,170,855
247400617.0,CC des Vallées de Thônes,263,228,243,232,108,127,1201
200043628.0,CC des Vallées du Clain,272,256,263,310,176,248,1525
200071868.0,CC des Vallées du Haut-Anjou,507,469,429,584,268,418,2675
246900724.0,CC des Vallons du Lyonnais (Ccvl),353,254,276,339,151,203,1576
244200614.0,CC des Vals d'Aix et Isable,76,67,64,92,30,70,399
247600588.0,CC des Villes Soeurs,613,478,546,776,397,764,3574
200068773.0,CC des Vosges Côté Sud Ouest,172,108,136,142,98,196,852
200069060.0,CC des Vosges du Sud,223,167,164,167,111,139,971
242600492.0,CC Dieulefit-Bourdeaux,151,117,122,191,99,140,820
200042497.0,CC Dombes Saône Vallée,519,380,396,436,182,200,2113
200069169.0,CC Dômes Sancy Artense,163,79,137,178,81,127,765
200071520.0,CC Domfront Tinchebray Interco,194,187,163,201,119,184,1048
242900645.0,CC Douarnenez Communauté,387,263,345,421,199,361,1976
200042901.0,CC Drôme Sud Provence,848,642,696,1030,463,738,4417
200041572.0,CC Dronne et Belle,172,130,148,170,77,116,813
200069003.0,CC du Barséquanais en Champagne,280,214,218,310,188,340,1550
243200409.0,CC du Bas Armagnac,125,78,115,104,63,103,588
200073245.0,CC du Bassin d'Aubenas,907,666,664,974,471,824,4506
200044253.0,CC du Bassin de Joinville en Champagne,195,150,147,258,140,220,1110
241700699.0,CC du Bassin de Marennes,363,222,221,303,164,243,1516
245400601.0,CC du Bassin de Pompey,512,432,472,664,365,574,3019
200041515.0,CC du Bassin de Pont-à-Mousson,575,485,559,699,364,517,3199
200043982.0,CC du Bazadais,277,229,251,287,165,244,1453
200067288.0,CC du Béarn des Gaves,247,194,207,258,120,209,1235
200071496.0,CC du Bocage Bourbonnais,186,135,144,226,108,217,1016
245300389.0,CC du Bocage Mayennais,213,175,155,185,119,172,1019
242852465.0,CC du Bonnevalais,164,144,139,166,80,138,831
240500439.0,CC du Briançonnais,456,345,473,483,260,309,2326
240200584.0,CC du Canton de Charly-sur-Marne,243,204,229,265,111,215,1267
247600497.0,CC du Canton de Criquetot-l'Esneval,206,166,147,257,118,162,1056
247300361.0,CC du Canton de la Chambre,103,89,94,91,39,59,475
247103864.0,CC du Canton de Semur-en-Brionnais,54,47,47,74,42,57,321
200067924.0,CC du Canton d'Erstein,637,450,476,604,342,481,2990
240200519.0,CC du Canton d'Oulchy-le-Château,82,75,76,88,66,103,490
200042943.0,CC du Cap Corse,222,87,79,83,28,41,540
243700499.0,CC du Castelrenaudais,219,208,218,307,155,255,1362
200030633.0,CC du Caudrésis et du Catésis,1225,1057,1246,1762,897,1501,7688
244600573.0,CC du Causse de Labastide-Murat,59,35,39,46,30,42,251
242020071.0,CC du Centre Corse,180,89,71,84,38,41,503
246800445.0,CC du Centre du Haut-Rhin,204,163,157,225,98,156,1003
200071041.0,CC du Chaourçois et du Val d'Armance,136,99,146,163,98,147,789
200035848.0,CC du Châtillonnais en Berry,82,64,68,63,43,76,396
240200592.0,CC du Chemin des Dames,68,80,91,104,48,89,480
200070035.0,CC du Civraisien en Poitou,295,296,352,398,205,320,1866
243400355.0,CC du Clermontais,568,518,575,679,357,546,3243
246000376.0,CC du Clermontois,503,432,437,588,313,436,2709
200040293.0,CC du Clunisois,165,140,162,186,102,121,876
200068922.0,CC du Confluent et des Coteaux de Prayssas,330,280,295,431,258,427,2021
200034064.0,CC du Cordais et du Causse (4 C),94,56,52,88,52,74,416
243301215.0,CC du Créonnais,247,212,217,265,154,241,1336
200040509.0,CC du Crestois et de Pays de Saillans Coeur de Drôme,390,326,337,449,216,316,2034
242600534.0,CC du Diois,279,199,227,310,149,228,1392
245700133.0,CC du District Urbain de Faulquemont (Duf),331,263,316,406,196,287,1799
242504447.0,CC du Doubs Baumois,191,171,151,242,118,184,1057
243301397.0,CC du Fronsadais,253,225,254,281,145,249,1407
200034957.0,CC du Frontonnais,381,300,294,420,194,283,1872
248900748.0,CC du Gâtinais en Bourgogne,237,189,223,263,143,203,1258
247400690.0,CC du Genevois,753,577,604,679,237,208,3058
244800470.0,CC du Gévaudan,110,102,83,114,62,91,562
200036077.0,CC du Golfe de Saint-Tropez,3302,1014,863,1421,703,772,8075
243200458.0,CC du Grand Armagnac,226,154,183,210,103,190,1066
200070530.0,CC du Grand Autunois Morvan,552,485,462,623,299,645,3066
244100798.0,CC du Grand Chambord,268,198,227,270,168,246,1377
200069961.0,CC du Grand Châteaudun,587,462,496,598,260,482,2885
200072999.0,CC du Grand Langres,336,259,262,334,174,205,1570
200022986.0,CC du Grand Pic Saint-Loup,630,556,601,787,360,529,3463
242500338.0,CC du Grand Pontarlier,549,338,397,442,222,270,2218
200070977.0,CC du Grand Roye,443,368,418,529,285,457,2500
200035533.0,CC du Grand Saint-Émilionnais,287,198,205,293,139,213,1335
200069383.0,CC du Grand Villefranchois,418,311,313,421,214,276,1953
200067452.0,CC du Guillestrois et du Queyras,158,141,182,244,104,163,992
242900710.0,CC du Haut Pays Bigouden,277,203,256,313,138,232,1419
200069235.0,CC du Haut Pays du Montreuillois,209,176,172,223,118,187,1085
249500489.0,CC du Haut Val d'Oise,668,557,634,685,304,345,3193
246600548.0,CC du Haut Vallespir,254,163,171,207,111,162,1068
200006930.0,CC du Haut-Allier,78,34,36,70,37,45,300
200067262.0,CC du Haut-Béarn,694,367,465,533,254,405,2718
247400682.0,CC du Haut-Chablais,180,149,197,194,87,106,913
243900479.0,CC du Haut-Jura (Arcade),193,134,138,168,65,83,781
244301107.0,CC du Haut-Lignon,118,69,90,102,57,92,528
200069763.0,CC du Haut-Poitou,514,480,477,625,302,471,2869
248900938.0,CC du Jovinien,373,257,299,393,186,281,1789
200034635.0,CC du Kochersberg,220,197,177,251,126,181,1152
242200715.0,CC du Kreiz-Breizh (Cckb),268,218,251,325,151,252,1465
247300668.0,CC du Lac d'Aiguebelette (Ccla),71,72,51,89,43,44,370
200034056.0,CC du Lautrécois et du Pays d'Agout,170,159,214,230,139,169,1081
246000129.0,CC du Liancourtois,339,287,289,415,179,294,1803
200071926.0,CC du Limouxin,524,418,450,581,312,413,2698
246300966.0,CC du Massif du Sancy,211,121,139,182,113,157,923
243801024.0,CC du Massif du Vercors,197,121,152,225,98,138,931
200042182.0,CC du Mont des Avaloirs,207,170,150,218,91,197,1033
242101491.0,CC du Montbardois,144,130,120,209,88,177,868
245804497.0,CC du Nivernais Bourbonnais,66,40,62,79,29,60,336
200006716.0,CC du Nogentais,281,217,220,288,157,212,1375
200067296.0,CC du Nord Est Béarn,418,343,396,524,227,294,2202
200071173.0,CC du Pays Arnay Liernais,71,53,87,91,48,84,434
240700302.0,CC du Pays Beaume-Drobie,201,151,178,220,125,188,1063
240100891.0,CC du Pays Bellegardien (Ccpb),415,312,331,387,182,251,1878
242900702.0,CC du Pays Bigouden Sud,622,463,467,627,262,469,2910
242101434.0,CC du Pays Châtillonnais,270,247,251,362,194,302,1626
242101459.0,CC du Pays d'Alésia et de la Seine,93,75,72,106,58,92,496
244400552.0,CC du Pays d'Ancenis,989,842,808,1007,525,754,4925
200034270.0,CC du Pays de Barr,322,255,298,338,182,245,1640
200069441.0,CC du Pays de Bitche,454,333,360,513,273,423,2356
246000913.0,CC du Pays de Bray,259,224,233,362,177,298,1553
200070332.0,"CC du Pays de Chalindrey, de Vannier Amance et de la Région de Bourbonne-Les-Bains",201,162,163,244,98,175,1043
245300447.0,CC du Pays de Château-Gontier,417,335,356,428,246,383,2165
245400510.0,CC du Pays de Colombey et du Sud Toulois,149,118,127,144,63,108,709
242700276.0,CC du Pays de Conches,258,219,216,327,178,322,1520
200048551.0,CC du Pays de Craon,338,282,289,348,195,264,1716
247400112.0,CC du Pays de Cruseilles,186,159,133,182,80,63,803
200070670.0,CC du Pays de Dol et de la Baie du Mont-Saint-Michel,392,246,286,392,190,275,1781
244700449.0,CC du Pays de Duras,69,68,70,96,54,82,439
241400514.0,CC du Pays de Falaise,468,352,422,535,246,336,2359
200004802.0,CC du Pays de Fayence,563,365,381,494,241,234,2278
200040830.0,CC du Pays de Fénelon,202,130,138,181,77,112,840
240100750.0,CC du Pays de Gex,1352,966,1136,1295,530,442,5721
200066827.0,CC du Pays de Honfleur-Beuzeville,623,393,444,524,239,335,2558
248500415.0,CC du Pays de la Châtaigneraie,234,152,158,220,113,195,1072
240200469.0,CC du Pays de la Serre,214,174,236,316,159,376,1475
246700959.0,CC du Pays de la Zorn,158,123,120,171,87,113,772
244600532.0,CC du Pays de Lalbenque-Limogne,133,106,101,140,71,117,668
200016905.0,CC du Pays de Lamastre,93,70,111,118,49,97,538
242900801.0,CC du Pays de Landerneau-Daoulas,631,558,566,791,350,596,3492
242900751.0,CC du Pays de Landivisiau,457,376,433,552,291,501,2610
240300491.0,CC du Pays de Lapalisse,99,90,111,122,79,134,635
246900625.0,CC du Pays de l'Arbresle (Ccpa),510,410,407,494,196,373,2390
244700464.0,CC du Pays de Lauzun,129,106,140,165,81,134,755
247200686.0,CC du Pays de l'huisne Sarthoise,426,388,382,500,227,395,2318
249100074.0,CC du Pays de Limours (Ccpl),227,180,186,208,103,134,1038
245300306.0,CC du Pays de Loiron,214,161,170,210,106,137,998
247700065.0,CC du Pays de l'Ourcq,236,224,244,284,141,192,1321
246900765.0,CC du Pays de l'Ozon,290,235,262,304,143,188,1422
200066603.0,CC du Pays de Lubersac-Pompadour,103,62,85,101,60,75,486
246201016.0,CC du Pays de Lumbres,277,241,278,426,199,330,1751
243400520.0,CC du Pays de Lunel,1189,1030,1049,1371,727,1054,6420
247000664.0,CC du Pays de Lure,330,278,293,318,174,338,1731
247000755.0,CC du Pays de Luxeuil,261,236,225,272,155,220,1369
200023075.0,CC du Pays de Maîche,249,171,216,250,144,171,1201
241500271.0,CC du Pays de Mauriac,70,60,62,72,29,49,342
245300223.0,CC du Pays de Meslay-Grez,170,183,159,188,87,132,919
200044469.0,CC du Pays de Mirepoix,213,162,183,212,114,138,1022
200041853.0,CC du Pays de Montbozon et du Chanois,80,66,56,65,44,65,376
244300307.0,CC du Pays de Montfaucon,111,79,90,94,46,87,507
245501259.0,CC du Pays de Montmédy,76,56,65,90,63,86,436
200043321.0,CC du Pays de Mormal,631,590,591,860,453,617,3742
248500662.0,CC du Pays de Mortagne,367,280,282,353,172,246,1700
200036069.0,CC du Pays de Mortagne-au-Perche,163,165,168,205,92,139,932
246701098.0,CC du Pays de Niederbronn-les-Bains,335,242,286,314,185,271,1633
245700950.0,CC du Pays de Phalsbourg,227,178,191,226,119,147,1088
200000438.0,CC du Pays de Pontchâteau Saint-Gildas-des-Bois,538,430,451,620,292,486,2817
248500464.0,CC du Pays de Pouzauges,351,301,282,336,151,250,1671
245501184.0,CC du Pays de Revigny-sur-Ornain,83,84,95,105,48,100,515
246800577.0,CC du Pays de Ribeauvillé,239,138,184,204,123,157,1045
246800494.0,"CC du Pays de Rouffach, Vignobles et Châteaux",149,105,107,121,61,114,657
242400935.0,CC du Pays de Saint-Aulaye,106,95,84,118,54,98,555
200072080.0,CC du Pays de Saint-Éloy,217,179,204,229,117,169,1115
246701080.0,CC du Pays de Sainte-Odile,257,178,227,276,162,228,1328
200071918.0,CC du Pays de Saint-Fulgent - les Essarts,371,294,287,331,179,259,1721
200023778.0,CC du Pays de Saint-Gilles-Croix-de-Vie,981,756,653,863,453,744,4450
248700189.0,CC du Pays de Saint-Yrieix,167,148,146,155,64,160,840
241200658.0,CC du Pays de Salars,82,65,67,81,37,45,377
241501139.0,CC du Pays de Salers,103,60,60,98,46,55,422
242504371.0,CC du Pays de Sancey-Belleherbe,45,46,50,75,26,36,278
200068112.0,CC du Pays de Saverne,533,435,405,516,288,393,2570
200040418.0,CC du Pays de Serres en Quercy,140,119,118,165,87,118,747
243000296.0,CC du Pays de Sommières,430,366,364,496,250,460,2366
200066132.0,CC du Pays de Stenay et du Val Dunois,125,118,112,149,73,143,720
240900431.0,CC du Pays de Tarascon,197,105,125,135,87,98,747
200070795.0,CC du Pays de Trie et du Magnoac,98,67,67,94,34,59,419
240300558.0,CC du Pays de Tronçais,94,72,85,116,58,125,550
246000871.0,CC du Pays de Valois,737,657,652,807,431,639,3923
244000774.0,CC du Pays de Villeneuve en Armagnac Landais,92,66,84,94,55,72,463
247000714.0,CC du Pays de Villersexel,106,74,102,122,57,107,568
246700926.0,CC du Pays de Wissembourg,217,134,177,207,141,180,1056
242900553.0,CC du Pays des Abers,573,498,428,550,303,438,2790
248500530.0,CC du Pays des Achards,295,217,253,297,163,244,1469
240500462.0,CC du Pays des Ecrins,149,92,136,142,80,97,696
248500621.0,CC du Pays des Herbiers,519,395,405,427,213,327,2286
243900719.0,CC du Pays des Lacs,97,70,69,90,41,48,415
240600593.0,CC du Pays des Paillons,410,309,302,378,192,223,1814
248400319.0,CC du Pays des Sorgues et des Monts de Vaucluse,726,467,560,728,372,570,3423
246000855.0,CC du Pays des Sources,273,257,263,371,182,283,1629
245501242.0,CC du Pays d'Étain,107,83,100,129,61,113,593
247000722.0,CC du Pays d'Héricourt,360,259,332,372,171,270,1764
240300657.0,CC du Pays d'Huriel,106,81,90,113,63,111,564
242900074.0,CC du Pays d'Iroise,574,540,487,627,282,447,2957
243600236.0,CC du Pays d'Issoudun,336,263,280,345,191,362,1777
240900464.0,CC du Pays d'Olmes,338,217,263,362,177,264,1621
241000447.0,CC du Pays d'Othe,133,88,99,146,80,117,663
248000747.0,CC du Pays du Coquelicot,400,348,392,505,272,523,2440
242700607.0,CC du Pays du Neubourg,242,204,232,296,162,322,1458
200035772.0,CC du Pays du Saintois,168,127,138,152,91,131,807
245400759.0,CC du Pays du Sanon,67,67,69,75,42,63,383
240200493.0,CC du Pays du Vermandois,489,504,524,606,365,662,3150
244200820.0,CC du Pays d'Urfé,56,45,53,67,26,57,304
241927243.0,CC du Pays d'Uzerche,99,82,90,116,59,76,522
244200630.0,CC du Pays entre Loire et Rhône,179,129,131,182,77,135,833
200071652.0,CC du Pays Fertois et du Bocage Carrougien,73,45,50,63,30,43,304
247200348.0,CC du Pays Fléchois,419,376,396,467,202,448,2308
242900660.0,CC du Pays Fouesnantais,471,354,304,406,211,283,2029
243301371.0,CC du Pays Foyen,336,283,293,338,189,337,1776
241500255.0,CC du Pays Gentiane,54,50,31,57,27,44,263
244000824.0,CC du Pays Grenadois,100,80,89,119,58,95,541
245701404.0,CC du Pays Haut Val d'Alzette,360,244,332,406,211,328,1881
247800550.0,CC du Pays Houdanais (C.C.P.H.),304,280,274,339,145,217,1559
248600447.0,CC du Pays Loudunais,444,309,343,496,237,441,2270
244000691.0,CC du Pays Morcenais,132,119,121,170,94,133,769
246900740.0,CC du Pays Mornantais (Copamo),283,260,240,302,125,195,1405
246000756.0,CC du Pays Noyonnais,644,513,560,748,427,640,3532
245701271.0,CC du Pays Orne Moselle,826,750,802,1065,592,809,4844
200043156.0,CC du Pays Rethélois,412,334,387,483,263,357,2236
248400236.0,CC du Pays Réuni d'Orange,1082,817,897,1098,565,827,5286
200041325.0,CC du Pays Rhénan,438,325,341,452,256,409,2221
200040400.0,CC du Pays Ribéracois,252,215,246,295,154,245,1407
241200625.0,CC du Pays Rignacois,58,53,51,58,35,44,299
247000706.0,CC du Pays Riolais,153,124,123,156,76,108,740
247400724.0,CC du Pays Rochois,456,317,330,348,141,156,1748
243800778.0,CC du Pays Roussillonnais,1045,742,862,997,417,460,4523
245901038.0,CC du Pays Solesmois,219,193,239,316,195,309,1471
244000766.0,CC du Pays Tarusate,278,228,255,300,141,247,1449
243000270.0,CC du Pays Viganais,249,191,191,253,104,183,1171
200006971.0,CC du Perche,305,257,260,334,147,284,1587
200040772.0,CC du Perche et Haut Vendômois,103,81,102,135,51,118,590
200071819.0,CC du Périgord Nontronnais,208,165,161,212,113,136,995
200034411.0,CC du Piémont Cévenol,413,335,415,518,207,399,2287
244200895.0,CC du Pilat Rhodanien,247,185,194,241,139,176,1182
200066280.0,CC du Pithiverais,552,417,492,566,262,438,2727
200071850.0,CC du Pithiverais-Gâtinais,417,349,337,440,219,374,2136
242504496.0,CC du Plateau de Frasne et du Val de Drugeon (Cfd),69,68,67,80,35,47,366
200070787.0,CC du Plateau de Lannemezan,302,195,242,273,148,230,1390
241200674.0,CC du Plateau de Montbazens,72,61,48,62,27,38,308
242504355.0,CC du Plateau de Russey,96,59,60,81,55,38,389
240100578.0,CC du Plateau d'Hauteville,70,60,41,65,23,49,308
246000566.0,CC du Plateau Picard,477,386,427,544,269,362,2465
243000684.0,CC du Pont du Gard,435,407,402,484,262,394,2384
200037133.0,CC du Provinois,557,419,461,584,248,396,2665
200039519.0,CC du Quercy Blanc,112,92,73,130,55,112,574
248200057.0,CC du Quercy Caussadais,398,314,296,441,215,336,2000
248200107.0,CC du Quercy Rouergue et des Gorges de l'Aveyron,127,105,113,160,79,107,691
200044394.0,CC du Réolais en Sud Gironde,451,355,426,522,233,421,2408
241200542.0,CC du Réquistanais,47,37,41,53,19,38,235
240700864.0,CC du Rhône aux Gorges de l'Ardèche,391,311,343,491,240,363,2139
200030526.0,CC du Ried de Marckolsheim,314,197,261,280,154,228,1434
200018406.0,CC du Romorantinais et du Monestois,530,424,491,607,282,540,2874
241600303.0,CC du Rouillacais,152,111,105,180,101,168,817
200067767.0,CC du Royans-Vercors,168,121,158,168,91,125,831
245500327.0,CC du Sammiellois,119,77,125,155,71,179,726
242010130.0,CC du Sartenais Valinco,640,147,104,131,32,35,1089
245701206.0,CC du Saulnois,371,309,285,408,185,302,1860
243200599.0,CC du Saves,134,101,107,130,51,86,609
243301249.0,CC du Secteur de Saint-Loubès,414,349,385,434,246,333,2161
244000659.0,CC du Seignanx,571,415,373,520,212,342,2433
200039709.0,CC du Serein,82,42,50,100,49,73,396
200068765.0,CC du Sisteronais-Buëch,401,353,408,542,268,434,2406
248100158.0,CC du Sor et de l'Agout,320,299,349,416,185,274,1843
200043404.0,CC du Sud Avesnois,514,467,542,768,382,610,3283
200040764.0,CC du Sud Corse,1996,405,220,239,74,61,2995
247200421.0,CC du Sud Est du Pays Manceau,178,174,177,225,116,196,1066
200043974.0,CC du Sud Gironde,798,648,683,890,437,711,4167
245100979.0,CC du Sud Marnais,92,89,111,108,76,108,584
200039907.0,CC du Sud Messin,151,146,154,162,99,142,854
249000241.0,CC du Sud Territoire,386,285,379,416,242,308,2016
200035442.0,CC du Sud-Artois,404,299,367,444,220,343,2077
244400586.0,CC du Sud-Estuaire,483,425,396,514,246,427,2491
200069672.0,CC du Ternois,551,424,531,695,288,409,2898
200041150.0,CC du Terrassonnais en Périgord Noir Thenon Hautefort,396,281,325,358,178,273,1811
243800844.0,CC du Territoire de Beaurepaire,288,191,213,267,123,178,1260
245501176.0,CC du Territoire de Fresnes-en-Woëvre,66,29,55,68,40,51,309
200070324.0,CC du Territoire de Lunéville à Baccarat,611,553,581,787,435,792,3759
200070951.0,CC du Territoire Nord Picardie,420,341,447,601,312,626,2747
247900798.0,CC du Thouarsais,634,454,494,679,299,465,3025
200041861.0,CC du Triangle Vert,145,136,113,154,85,112,745
200030658.0,CC du Trièves,145,88,136,154,91,123,737
200043065.0,CC du Val d'Amboise,547,425,448,560,279,479,2738
243900420.0,CC du Val d'Amour,111,98,96,102,56,63,526
246800395.0,CC du Val d'Argent,152,95,139,183,73,150,792
240700716.0,CC du Val d'Ay,95,53,69,84,39,56,396
200018521.0,CC du Val de Bouzanne,69,53,69,87,61,69,408
240300566.0,CC du Val de Cher,70,66,59,88,44,93,420
242600252.0,CC du Val de Drôme,575,512,491,610,284,428,2900
240200501.0,CC du Val de l'Aisne,273,220,228,383,224,418,1746
243301405.0,CC du Val de l'Eyre,310,274,301,332,178,258,1653
200040426.0,CC du Val de l'Oise,196,189,221,317,192,371,1486
242504116.0,CC du Val de Morteau,329,215,259,275,149,153,1380
247200629.0,CC du Val de Sarthe,392,367,331,469,232,420,2211
248000499.0,CC du Val de Somme,325,276,332,378,233,416,1960
200070100.0,CC du Val de Sully,354,279,318,428,219,359,1957
248719288.0,CC du Val de Vienne,161,158,150,185,72,136,862
249100546.0,CC du Val d'Essonne (Ccve),607,537,505,622,238,410,2919
243500667.0,CC du Val d'Ille-Aubigné,420,364,420,484,223,367,2278
246100390.0,CC du Val d'Orne,77,55,61,88,45,79,405
200041887.0,CC du Val Marnaysien,174,104,136,193,94,129,830
246600373.0,CC du Vallespir,489,329,387,457,231,392,2285
200071843.0,CC du Vexin Normand,535,473,539,612,320,516,2995
246000707.0,CC du Vexin-Thelle,229,223,221,283,149,193,1298
249500513.0,CC du Vexin-Val de Seine,225,162,173,265,131,193,1149
200070944.0,CC du Vimeu,388,316,349,432,222,404,2111
200066819.0,CC du Volvestre,488,363,425,534,269,461,2540
245701164.0,CC du Warndt,290,232,267,398,228,325,1740
200040558.0,CC Écueillé-Valençay,148,104,106,157,96,135,746
200068872.0,CC Éguzon - Argenton - Vallée de la Creuse,271,222,270,348,184,285,1580
200066512.0,CC Élan Limousin Avenir Nature,292,286,347,413,220,346,1904
200040681.0,CC Enclave des Papes-Pays de Grignan,403,316,373,554,246,445,2337
200071470.0,CC Entr'Allier Besbre et Loire,300,270,269,413,208,422,1882
200070316.0,"CC Entre Arroux, Loire et Somme",306,233,252,346,180,285,1602
200058360.0,CC Entre Beauce et Perche,259,199,236,296,133,243,1366
246301097.0,CC Entre Dore et Allier,219,192,250,324,169,316,1470
249100553.0,CC Entre Juine et Renarde (Ccejr),309,271,251,258,130,172,1391
247103765.0,CC Entre Saône et Grosne,148,127,125,178,71,154,803
200072734.0,CC Estuaire et Sillon,494,419,465,555,259,413,2605
242700623.0,CC Eure-Madrie-Seine,425,383,380,490,267,440,2385
247600729.0,CC Falaises du Talou,320,249,332,483,251,408,2043
200000172.0,CC Faucigny-Glières,498,312,335,447,181,215,1988
241800457.0,CC Fercher Pays Florentais,147,112,137,201,98,174,869
247400567.0,CC Fier et Usses,211,182,170,204,82,111,960
245900758.0,CC Flandre Lys,563,432,516,635,307,459,2912
241000223.0,"CC Forêts, Lacs, Terres en Champagne",98,71,98,106,58,71,502
200039063.0,"CC Forêts, Seine et Suzon",55,48,58,84,29,56,330
200068930.0,CC Fumel Vallée du Lot,405,263,348,421,270,391,2098
200034130.0,CC Gally Mauldre,199,155,166,209,96,161,986
248719262.0,CC Gartempe - Saint-Pardoux,56,34,62,71,50,66,339
200023919.0,CC Gâtinais Val de Loing,302,223,239,260,170,217,1411
244500211.0,CC Giennoises,520,380,436,507,256,487,2586
200069151.0,CC Gorges Causses Cévennes,195,93,99,113,76,59,635
243301223.0,CC Grand Cubzaguais,575,537,534,672,343,506,3167
200042646.0,CC Grand Orb CC en Languedoc,406,311,324,440,236,351,2068
200066652.0,CC Grand Sud Tarn et Garonne,761,617,661,895,387,597,3918
200067361.0,CC Grand-Figeac,701,502,555,573,248,335,2914
200067957.0,CC Haut Chemin-Pays de Pange,178,126,156,224,103,141,928
200071942.0,CC Haut Limousin en Marche,273,217,238,292,189,309,1518
200067429.0,CC Haut Nivernais-Val d'Yonne,154,124,127,183,108,131,827
200041994.0,CC Haut Val de Sèvre,392,323,337,438,225,398,2113
200072700.0,CC Haute Sarthe Alpes Mancelles,331,230,274,334,172,343,1684
200066108.0,CC Haute Saulx et Perthois-Val d'Ornois,196,186,189,246,130,232,1179
200066744.0,CC Haute-Corrèze Communauté,450,320,363,428,195,281,2037
200070340.0,CC Haute-Maurienne Vanoise,126,96,147,89,39,38,535
200071025.0,CC Haute-Provence-Pays de Banon,200,130,150,208,109,188,985
200066637.0,CC Hautes Terres,167,113,105,123,67,77,652
200026573.0,CC Haut-Jura Saint-Claude,346,256,265,333,156,218,1574
200067072.0,CC Haut-Léon Communauté,521,377,420,498,274,510,2600
200067650.0,CC Houve-Pays Boulageois,291,210,229,300,175,256,1461
200070449.0,CC Inter-Caux-Vexin,551,441,487,613,331,521,2944
200066462.0,CC Interco Normandie Sud Eure,528,497,527,655,359,623,3189
200066413.0,CC Intercom Bernay Terres de Normandie,752,672,780,935,499,941,4579
200068799.0,CC Intercom de la Vire au Noireau,694,604,646,795,348,630,3717
200069722.0,CC Interrégionale Aumale - Blangy-sur-Bresle,313,260,314,390,195,353,1825
200066801.0,CC Isigny-Omaha Intercom,452,270,275,379,180,314,1870
200040384.0,CC Isle Double Landais,240,161,169,212,113,226,1121
200069094.0,CC Isle et Crempse-en-Périgord,192,147,210,256,124,206,1135
200040095.0,CC Isle Vern Salembre en Périgord,275,222,265,341,145,279,1527
242401024.0,CC Isle-Loue-Auvézère en Périgord,162,152,140,177,99,124,854
200071033.0,CC Jabron-Lure-Vançon-Durance,87,65,77,98,50,71,448
243301165.0,CC Jalle-Eau-Bourde,401,353,308,400,197,285,1944
243900560.0,CC Jura Nord,145,129,144,151,92,110,771
243900412.0,CC Jura Sud,107,88,90,89,62,83,519
200070548.0,CC La Clayette Chauffailles en Brionnais,196,147,161,198,104,179,985
243400488.0,CC La Domitienne,557,459,474,570,328,463,2851
243900610.0,CC La Grandvallière,84,41,57,88,37,43,350
200068914.0,CC La Rochefoucauld - Porte du Périgord,273,237,237,363,184,338,1632
241800374.0,CC La Septaine,155,132,131,131,68,141,758
200040210.0,CC Lacs et Gorges du Verdon,227,121,126,159,84,122,839
200069391.0,CC Lamballe Terre et Mer,1030,804,802,991,491,752,4870
241200906.0,CC Larzac et Vallées,90,54,82,83,46,64,419
243301181.0,CC Latitude Nord Gironde,377,364,320,439,220,360,2080
243100567.0,CC Lauragais Revel Sorezois,363,253,338,410,203,348,1915
200070282.0,CC Lavalette Tude Dronne,208,175,222,283,127,243,1258
249100595.0,CC Le Dourdannais en Hurepoix (Ccdh),328,255,265,321,129,186,1484
241800424.0,CC Le Dunois,96,64,94,98,49,99,500
200072684.0,CC Le Gesnois Bilurien,379,353,346,481,227,399,2185
200071884.0,CC Le Grand Charolais,537,401,482,611,281,499,2811
200018166.0,CC Le Grésivaudan,1252,1050,1074,1273,641,837,6127
200039642.0,CC Le Tonnerrois en Bourgogne,215,203,190,272,167,196,1243
200069086.0,CC Leff Armor Communauté,472,344,393,546,290,411,2456
200071058.0,CC Les Avant-Monts,497,386,441,549,292,438,2603
200068542.0,CC Les Balcons du Dauphiné,1146,900,973,1163,571,629,5382
200023125.0,CC Les Portes Briardes entre Villes et Forêts,600,482,464,546,271,343,2706
200071074.0,CC Les Portes de l'Ile de France,314,280,293,330,185,248,1650
241800432.0,CC Les Trois Provinces,71,60,59,87,41,87,405
200068567.0,CC Les Vals du Dauphiné,984,758,815,1023,439,584,4603
247300817.0,CC Les Versants d'Aime,187,116,182,104,40,40,669
241800325.0,CC Les Villages de la Forêt,74,49,54,82,35,84,378
200068807.0,CC Lèze Ariège,502,461,457,563,257,455,2695
200066017.0,CC Lieuvin Pays d'Auge,265,224,245,309,150,263,1456
243500774.0,CC Liffré-Cormier Communauté,290,245,266,358,142,203,1504
200071587.0,CC Loches Sud Touraine,740,631,680,866,378,660,3955
200017341.0,CC Lodévois et Larzac,345,270,302,394,197,276,1784
245801063.0,CC Loire et Allier,80,60,67,66,34,43,350
244301131.0,CC Loire et Semène,285,229,248,276,140,230,1408
200071553.0,CC Loire Layon Aubance,720,671,651,795,381,743,3961
200068088.0,"CC Loire, Nièvre et Bertranges",230,170,193,289,150,228,1260
200067916.0,"CC Loire, Vignobles et Nohain",335,279,261,413,197,307,1792
200070373.0,CC Loir-Lucé-Bercé,360,313,325,388,210,418,2014
247700644.0,CC l'Orée de la Brie,352,327,300,348,146,170,1643
244701405.0,CC Lot et Tolzac,120,82,104,153,62,104,625
200067460.0,CC Loudéac Communauté - Bretagne Centre,803,646,696,802,390,548,3885
200040475.0,CC Loué - Brûlon - Noyen,264,219,211,294,155,214,1357
200068070.0,CC Loue-Lison,300,214,247,320,165,190,1436
243800935.0,CC Lyon Saint-Éxupéry-en-Dauphiné,451,363,437,472,234,274,2231
200070142.0,CC Lyons Andelle,284,229,306,390,202,373,1784
200069698.0,CC Mâconnais - Tournugeois,254,168,229,274,154,200,1279
200070738.0,CC Mad et Moselle,214,209,208,262,145,203,1241
200068963.0,CC Maine Coeur de Sarthe,231,206,230,251,132,252,1302
200072676.0,CC Maine Saosnois,441,352,399,476,237,401,2306
200035137.0,CC Marche Occitane - Val d'Anglin,95,76,69,94,50,65,449
200073427.0,CC Marches du Velay-Rochebaron,457,366,411,460,224,384,2302
244000865.0,CC Maremne Adour Côte Sud,2117,1113,1010,1403,657,878,7178
247300452.0,CC Maurienne Galibier,65,57,75,61,30,26,314
200055887.0,CC Mayenne Communauté,454,435,375,454,228,325,2271
200027100.0,CC Méditerranée Porte des Maures,1128,610,633,825,446,651,4293
200070720.0,CC Médoc Atlantique,742,457,412,646,365,547,3169
200069995.0,CC Médoc Coeur de Presqu'ile,705,549,525,739,381,519,3418
243301447.0,CC Médoc Estuaire,399,343,362,417,237,299,2057
243301389.0,CC Médullienne,336,244,263,352,187,249,1631
200069755.0,CC Mellois-en-Poitou,625,463,488,659,363,455,3053
200067643.0,"CC Meurthe, Mortagne, Moselle",209,164,189,246,138,228,1174
200069664.0,CC Meuse Rognon,116,110,130,152,51,120,679
200073401.0,CC Mézenc-Loire-Meygal,142,116,130,137,68,97,690
200066769.0,CC Midi Corrézien,181,127,161,179,108,160,916
200066348.0,CC Minervois Saint-Ponais Orb-Jaur,280,201,199,297,174,291,1442
200072825.0,CC Mirebellois et Fontenois,116,127,117,142,67,114,683
200069177.0,CC Mond'Arverne Communauté,445,396,383,534,256,441,2455
200069128.0,CC Mont Lozère,85,56,54,71,34,58,358
243500550.0,CC Montfort Communauté,315,257,250,350,139,250,1561
200067197.0,CC Monts d'Arrée Communauté,117,100,116,139,76,127,675
200067510.0,CC Monts et Vallées Ouest Creuse,321,237,260,303,154,236,1511
200067163.0,"CC Monts, Rance et Rougier",73,67,72,90,44,74,420
247700032.0,CC Moret Seine et Loing,492,409,419,548,264,366,2498
200067890.0,CC Morvan Sommets et Grands Lacs,133,113,126,154,71,135,732
245400171.0,CC Moselle et Madon,352,230,285,370,223,278,1738
200073120.0,CC Nebbiu - Conca d'Oro,333,74,58,86,42,36,629
200070829.0,CC Neste Barousse,108,83,89,123,49,71,523
200071223.0,CC Nièvre et Somme,411,364,458,588,317,652,2790
200069540.0,CC Norge et Tille,131,115,122,133,91,104,696
200065563.0,CC Normandie-Cabourg-Pays d'Auge,560,349,351,502,282,362,2406
248500258.0,CC Océan Marais de Monts,453,300,277,368,180,319,1897
247200447.0,CC Orée de Bercé - Belinois,237,197,223,274,163,284,1378
200070845.0,CC Orne Lorraine Confluences,818,640,718,903,525,846,4450
200044048.0,CC Osartis Marquion,573,468,501,786,437,523,3288
200039055.0,CC Ouche et Montagne,120,97,93,140,78,133,661
200066520.0,CC Ouest Limousin,135,121,120,138,71,161,746
200073138.0,CC Pasquale Paoli,135,47,57,77,36,52,404
247700438.0,CC Pays Créçois,418,321,341,424,187,278,1969
200040624.0,CC Pays d'Apt-Luberon,781,461,523,597,289,445,3096
248500340.0,CC Pays de Chantonnay,351,305,326,338,187,279,1786
243500659.0,CC Pays de Châteaugiron Communauté,326,301,255,328,123,210,1543
200071934.0,CC Pays de Fontenay-Vendée,574,448,498,695,338,563,3116
200070290.0,CC Pays de l'Audunois et du Bassin de Landres,302,204,274,378,188,304,1650
247700107.0,CC Pays de Montereau,857,627,751,844,387,479,3945
246401756.0,CC Pays de Nay,372,272,318,399,217,305,1883
200023240.0,CC Pays de Nemours,477,374,435,505,241,351,2383
200007177.0,CC Pays de Nérondes,62,58,50,74,40,82,366
200070506.0,CC Pays de Nexon Monts de Chalus,149,128,130,172,74,135,788
200039832.0,CC Pays des Vans en Cévennes,223,176,136,258,115,201,1109
200071967.0,CC Pays d'Évian Vallée d'Abondance,884,592,578,615,267,267,3203
200072478.0,CC Pays d'Opale,401,319,336,499,285,523,2363
200069417.0,CC Pays d'Orthe et Arrigans,401,288,340,455,271,331,2086
200034882.0,CC Pays du Mont-Blanc,752,511,538,545,268,261,2875
200034379.0,CC Pays d'Uzès,493,358,415,502,262,447,2477
240400440.0,CC Pays Forcalquier et Montagne de Lure,231,142,158,274,114,169,1088
200069227.0,CC Pays Fort Sancerrois Val de Loire,216,180,238,267,126,244,1271
200066025.0,CC Pays Rhin - Brisach,384,313,315,371,190,335,1908
200068831.0,CC Pays Ségali,187,142,164,214,108,127,942
242400752.0,CC Périgord-Limousin,211,165,157,187,103,142,965
200042992.0,CC Perthois-Bocage et Der,72,64,62,79,39,59,375
200012060.0,CC Petite Montagne,89,71,75,85,42,40,402
200041960.0,CC Pévèle-Carembault,1054,886,977,1322,643,1050,5932
200071769.0,CC Picardie des Châteaux,254,195,242,352,163,343,1549
200035707.0,CC Piège Lauragais Malepère,267,211,219,292,149,203,1341
200071199.0,CC Plaine Limagne,270,223,260,362,181,342,1638
200033090.0,CC Plaines et Monts de France,264,193,260,274,121,151,1263
200069847.0,CC Plateau de Caux-Doudeville-Yerville,276,249,266,327,165,310,1593
200067247.0,CC Pleyben-Châteaulin-Porzay,357,297,343,376,179,306,1858
200066777.0,CC Ploërmel Communauté,621,569,582,732,307,456,3267
242900744.0,CC Poher Communauté,208,187,195,263,123,185,1161
200070936.0,CC Ponthieu-Marquenterre,607,385,469,543,326,484,2814
245614433.0,CC Pontivy Communauté,637,608,621,724,350,560,3500
200036572.0,CC Porte d'Aquitaine en Pays de Serres,57,62,64,89,41,58,371
200040491.0,CC Porte de Drômardèche,916,709,789,981,507,650,4552
247300676.0,CC Porte de Maurienne,99,72,68,91,44,56,430
200072056.0,CC Porte du Jura,128,114,138,161,46,53,640
200059400.0,CC Porte Océane du Limousin,358,292,341,393,175,367,1926
200041556.0,CC Portes de la Creuse en Marche,81,73,74,109,46,94,477
200011781.0,CC Portes du Berry entre Loire et Val d'Aubois,117,90,117,134,71,181,710
200069524.0,CC Pré-Bocage Intercom,331,311,365,397,170,268,1842
200066868.0,CC Presqu'île de Crozon-Aulne Maritime,427,284,310,390,207,366,1984
200040202.0,CC Provence Verdon,417,334,361,452,214,315,2093
200043776.0,CC Pyrénées Audoises,241,180,198,277,156,242,1294
246600464.0,CC Pyrénées Catalanes,103,106,135,139,98,113,694
246600399.0,CC Pyrénées Cerdagne,173,109,147,151,83,96,759
200072635.0,CC Pyrénées Haut Garonnaises,335,187,220,257,128,212,1339
200070811.0,CC Pyrénées Vallées des Gaves,504,196,224,273,111,203,1511
244600482.0,CC Quercy - Bouriane,163,117,129,187,94,156,846
200066884.0,CC Quercy Vert-Aveyron,369,307,337,443,205,274,1935
245614383.0,CC Questembert Communauté,334,305,310,383,225,308,1865
247000821.0,CC Rahin et Cherimont,136,126,168,198,99,180,907
200069102.0,CC Randon - Margeride,56,36,43,53,19,22,229
200035863.0,"CC Région Lézignanaise, Corbières et Minervois",620,523,549,691,327,568,3278
200071991.0,CC Retz-en-Valois,452,405,450,629,304,570,2810
200041366.0,CC Rhône Crussol,452,373,387,523,248,374,2357
200000628.0,CC Rhône Lez Provence,570,453,476,609,307,472,2887
243000569.0,"CC Rhony, Vistre, Vidourle",510,371,411,562,264,376,2494
200029999.0,CC Rives de l'Ain - Pays du Cerdon,232,190,186,214,107,147,1076
200039949.0,CC Rives de Moselle,783,665,700,891,488,759,4286
242101509.0,CC Rives de Saône,271,237,265,310,176,280,1539
245614417.0,CC Roi Morvan Communauté,382,270,328,425,243,404,2052
200066405.0,CC Roumois Seine,577,509,520,718,403,623,3350
246600415.0,CC Roussillon-Conflent,462,352,333,526,253,414,2340
247400740.0,CC Rumilly Terre de Savoie,476,390,390,397,187,199,2039
200069599.0,CC Rurales de l'Entre-deux-Mers,230,249,234,271,169,282,1435
200067155.0,"CC Saint Affricain, Roquefort, Sept Vallons",195,155,186,219,91,157,1003
200071645.0,CC Saint Cyr Mère Boitier entre Charolais et Mâconnais,82,70,84,94,57,75,462
200070431.0,CC Saint-Marcellin Vercors Isère Communauté,634,571,574,798,362,585,3524
200071389.0,CC Saint-Pourçain Sioule Limagne,451,338,435,549,288,482,2543
200040038.0,CC Saône Doubs Bresse,157,132,141,176,98,169,873
200067817.0,CC Saône-Beaujolais,674,482,529,620,321,432,3058
200027217.0,CC Sarlat-Périgord Noir,503,239,238,310,159,240,1689
200068146.0,CC Sarrebourg Moselle Sud,777,507,596,696,331,462,3369
200013050.0,CC Sauer-Pechelbronn,204,140,163,201,134,192,1034
200000933.0,CC Sauldre et Sologne,223,173,179,236,104,176,1091
249500430.0,CC Sausseron Impressionnistes,212,150,157,225,109,182,1035
200071314.0,CC Save Garonne et Côteaux de Cadours,527,435,428,596,265,348,2599
200070126.0,CC Seine et Aube,130,107,128,175,93,165,798
200066975.0,CC Senlis Sud Oise,339,259,257,333,186,254,1628
200067304.0,CC Serein et Armance,388,308,291,400,225,321,1933
200067742.0,CC Serre-Ponçon,346,245,306,366,213,274,1750
200067320.0,CC Serre-Ponçon Val d'Avance,116,114,106,132,68,103,639
200069516.0,CC Seulles Terre et Mer,219,151,170,178,79,125,922
200067866.0,CC Sèvre et Loire,645,570,548,667,376,551,3357
200066561.0,CC Sidobre Vals et Plateaux,155,152,181,223,115,159,985
200071181.0,CC Somme Sud-Ouest,525,393,504,705,341,588,3056
200067049.0,CC Spelunca-Liamone,430,62,63,97,39,55,746
200066033.0,CC Sud Alsace Largue,320,219,247,251,138,185,1360
247104094.0,CC Sud Côte Chalonnaise,117,107,122,167,96,148,757
200067700.0,CC Sud Nivernais,262,228,234,272,152,247,1395
200071546.0,CC Sud Retz Atlantique,464,421,418,537,236,416,2492
200073112.0,CC Sud Sarthe,334,298,298,392,200,441,1963
200073260.0,CC Sud Vendée Littoral,965,759,710,927,508,802,4671
200042653.0,CC Sud-Hérault,346,265,280,362,181,292,1726
246600282.0,CC Sud-Roussillon,593,470,422,564,346,526,2921
241501055.0,CC Sumène - Artense,94,78,81,101,48,70,472
200066041.0,CC Sundgau,629,456,538,605,321,397,2946
200067692.0,CC Tannay-Brinon-Corbigny,104,69,89,114,57,123,556
200034023.0,CC Tarn-Agout,433,381,417,540,292,393,2456
243000650.0,CC Terre de Camargue,731,388,374,555,270,449,2767
200070928.0,CC Terre de Picardie,322,227,276,377,191,359,1752
200068682.0,CC Terre d'Eau,325,185,224,326,166,348,1574
200043693.0,CC Terre Lorraine du Longuyonnais,188,148,150,221,100,191,998
200071538.0,CC Terres de Bresse,319,245,283,317,178,291,1633
200069631.0,CC Terres de Chalosse,294,216,235,315,161,215,1436
200070233.0,"CC Terres de Montaigu, Cc Montaigu-Rocheservière",659,549,567,639,288,462,3164
200070167.0,CC Terres de Perche,217,218,226,252,132,217,1262
200041879.0,CC Terres de Saône,173,147,163,171,108,103,865
200066322.0,CC Terres des Confluences,1049,753,872,1164,601,847,5286
200066330.0,CC Terres du Haut-Berry,306,239,239,365,172,325,1646
200070563.0,CC Terres Touloises,636,532,554,678,313,529,3242
248400285.0,CC Territoriale Sud-Luberon,452,351,417,475,225,302,2222
200068534.0,CC Terroir de Caux,404,413,439,590,339,548,2733
200067973.0,CC Thelloise,804,667,737,1002,485,637,4332
200071983.0,CC Thiérache Sambre et Oise,313,274,297,361,216,413,1874
200070712.0,CC Thiers Dore et Montagne,676,506,566,860,470,775,3853
248100745.0,CC Thoré Montagne Noire,90,59,74,92,36,59,410
200070910.0,CC Tille et Venelle,58,50,57,77,31,64,337
200072981.0,CC Touraine Ouest Val de Loire,439,370,429,562,275,500,2575
200072668.0,CC Touraine Val de Vienne,409,317,294,450,229,378,2077
200072650.0,CC Touraine Vallée de l'Indre,653,533,573,759,371,570,3459
200073161.0,CC Touraine-Est Vallées,481,394,443,552,285,390,2545
200070852.0,CC Usses et Rhône,256,213,209,314,131,118,1241
248400335.0,CC Vaison Ventoux,324,219,240,337,173,267,1560
248100497.0,CC Val 81,72,61,57,66,36,66,358
200072874.0,CC Val Briard,325,267,284,327,137,196,1536
200043016.0,CC Val de Charente,226,200,202,253,135,209,1225
200069748.0,CC Val de Gâtine,280,230,274,318,160,270,1532
200072320.0,CC Val de Gers,108,94,98,108,55,88,551
200036549.0,CC Val de Gray,345,263,281,296,193,249,1627
240700617.0,CC Val de Ligne,147,101,96,171,81,150,746
243600301.0,CC Val de l'Indre - Brenne,184,147,178,205,133,172,1019
200066165.0,CC Val de Meuse - Voie Sacrée,112,95,98,117,71,95,588
200070118.0,CC Val de Saône Centre,272,172,192,238,112,124,1110
200065589.0,CC Val Ès Dunes,251,204,208,298,162,196,1319
200041465.0,CC Val Eyrieux,162,116,153,167,103,178,879
247300528.0,CC Val Guiers,170,127,157,216,76,119,865
200040798.0,CC Val Vanoise,140,103,128,59,24,25,479
243100773.0,CC Val'Aïgo,272,195,212,261,132,184,1256
200072064.0,CC Val-de-Cher-Controis,738,560,566,784,409,660,3717
200041051.0,CC Vallée de la Dordogne et Forêt Bessède,215,113,114,144,75,116,777
243400694.0,CC Vallée de l'Hérault,700,605,730,933,415,641,4024
200072304.0,CC Vallée de l'Ubaye - Serre-Ponçon,192,100,128,196,108,110,834
241300375.0,CC Vallée des Baux-Alpilles (Cc Vba),559,337,352,490,227,303,2268
200066728.0,CC Vallées de l'Orne et de l'Odon,293,223,253,296,158,245,1468
200067759.0,CC Vallées et Plateau d'Ardenne,331,320,343,476,244,444,2158
200043990.0,CC Vallons de Haute-Bretagne Communauté,556,500,537,617,344,538,3092
200041689.0,CC Vals de Saintonge,817,749,851,1070,510,908,4905
200071900.0,CC Vendée Grand Littoral,662,463,425,637,280,552,3019
248500563.0,"CC Vendée, Sèvre, Autise",252,185,223,266,150,210,1286
200035723.0,CC Ventoux Sud,211,145,143,202,89,134,924
200035970.0,CC Vexin Centre,235,217,238,283,146,244,1363
200066645.0,CC Vézère-Monédières-Millesources,50,46,53,52,28,34,263
200070043.0,CC Vienne et Gartempe,492,377,399,567,234,356,2425
200033207.0,CC Vierzon-Sologne-Berry,640,511,570,701,347,735,3504
200066751.0,CC Xaintrie Val'dordogne,153,94,98,136,82,116,679
248900896.0,CC Yonne Nord,332,278,285,369,193,253,1710
246300701.0,Clermont Auvergne Métropole,5007,3836,4011,5372,2560,4270,25056
244900015.0,CU Angers Loire Métropole,6019,5006,5131,6528,3238,5655,31577
200065597.0,CU Caen la Mer,5503,4224,4396,5323,2737,3986,26169
246100663.0,CU d'Alençon,994,804,803,860,442,603,4506
200033579.0,CU d'Arras,1741,1475,1623,2217,1153,1664,9873
245900428.0,CU de Dunkerque,3839,3234,3507,4885,2518,3948,21931
200067213.0,CU du Grand Reims,4966,4229,4349,5641,2859,4587,26631
200069854.0,CU du Grand-Poitiers,3257,2646,2628,3068,1450,2232,15281
200059889.0,CU Grand Paris Seine et Oise,7783,6143,6832,8201,3869,5299,38127
247100290.0,CU Le Creusot Montceau-les-Mines,1491,1201,1343,1595,958,1513,8101
247200132.0,CU Le Mans Métropole,4587,3735,3700,4766,2357,4024,23169
200027183.0,CU Perpignan Méditerranée Métropole,6332,5377,5188,6693,3398,5519,32507
242100410.0,Dijon Métropole,4716,3757,3809,4682,2368,3557,22889
246700488.0,Eurométropole de Strasbourg,9690,7295,8136,9824,5281,7997,48223
200054807.0,Métropole d'Aix-Marseille-Provence,38283,30420,33639,41084,20138,29087,192651
200046977.0,Métropole de LYON,27535,21900,22759,27003,12017,17636,128850
245400676.0,Métropole du Grand Nancy,4343,3513,3469,4363,2250,3848,21786
200054781.0,Métropole du Grand Paris,121445,93424,107975,131720,61968,108203,624735
245900410.0,Métropole Européenne de Lille,22396,17989,19587,25944,12347,21476,119739
200040715.0,Métropole Grenoble-Alpes-Métropole,8152,6153,6248,7431,3376,4839,36199
200030195.0,Métropole Nice Côte d'Azur,13151,8521,9208,10923,5265,7318,54386
200023414.0,Métropole Rouen Normandie,9617,8097,8250,10111,5089,9085,50249
248300543.0,Métropole Toulon-Provence-Méditerranée,8950,6308,6408,8184,3941,5699,39490
200039865.0,Metz Métropole,4217,3314,3436,4372,2338,3369,21046
243400017.0,Montpellier Méditerranée Métropole,11385,9480,9464,11474,5579,8278,55660
244400404.0,Nantes Métropole,12497,10525,10345,12688,5960,9548,61563
244500468.0,Orléans Métropole,5865,4373,4837,5492,2714,4649,27930
243500139.0,Rennes Métropole,8230,6954,6768,7880,3587,5640,39059
244200770.0,Saint-Etienne Métropole,7827,6092,6456,8050,3981,6508,38914
,Sans objet,208,81,50,103,58,95,595
243100518.0,Toulouse Métropole,18148,14409,14324,16779,7776,11516,82952
243700754.0,Tours Métropole Val de Loire,6000,5024,4829,6082,3047,4612,29594
,Hors EPCI,1592,1397,1599,2363,2301,4688,13940
