code_epci,lib_epci,anc_moins_3_mois,anc_3_a_5_mois,anc_6_a_11_mois,anc_12_a_23_mois,anc_24_a_35_mois,anc_plus_36_mois,total
200000172.0,CC Faucigny-Glières,465,334,389,412,201,241,2042
200000438.0,CC du Pays de Pontchâteau Saint-Gildas-des-Bois,521,429,420,550,304,490,2714
200000545.0,CC des Portes de Romilly-sur-Seine,485,376,348,456,206,396,2267
200000628.0,CC Rhône Lez Provence,508,400,493,591,281,483,2756
200000800.0,CC Coeur de Sologne,123,112,108,157,82,140,722
200000925.0,CC de la Plaine Dijonnaise,261,176,234,263,132,275,1341
200000933.0,CC Sauldre et Sologne,207,171,156,220,104,182,1040
200004802.0,CC du Pays de Fayence,519,331,358,452,208,304,2172
200005932.0,CC des Portes de Sologne,188,149,142,198,88,176,941
200005957.0,CC de la Région de Rambervillers,209,147,168,209,135,227,1095
200006682.0,"CA Beaune, Côte et Sud - Communauté Beaune-Chagny-Nolay",740,584,559,627,372,619,3501
200006716.0,CC du Nogentais,256,220,220,261,146,218,1321
200006930.0,CC du Haut-Allier,76,38,41,48,32,54,289
200006971.0,CC du Perche,266,239,282,327,172,291,1577
200007052.0,CC de la Marche Berrichonne,51,51,52,63,25,47,289
200007177.0,CC Pays de Nérondes,58,56,45,66,39,81,345
200010650.0,CA du Grand Dole,803,659,654,803,385,572,3876
200010700.0,CA Caux Seine Agglo,1161,989,982,1360,826,1550,6868
200011773.0,CA Annemasse-les Voirons-Agglomération,2157,1574,1636,1662,716,845,8590
200011781.0,CC Portes du Berry entre Loire et Val d'Aubois,113,93,111,154,80,164,715
200012060.0,CC Petite Montagne,87,62,63,92,46,61,411
200013050.0,CC Sauer-Pechelbronn,199,144,168,184,98,193,986
200015162.0,CC de l'Oriente,164,67,71,69,32,28,431
200016905.0,CC du Pays de Lamastre,108,80,84,129,68,91,560
200017341.0,CC Lodévois et Larzac,366,234,278,359,202,341,1780
200017846.0,CA Étampois Sud-Essonne (CCESE),899,671,662,761,381,487,3861
200018083.0,CC de Desvres-Samer,306,228,245,344,169,362,1654
200018166.0,CC Le Grésivaudan,1183,1025,1044,1180,597,900,5929
200018406.0,CC du Romorantinais et du Monestois,480,385,467,536,336,567,2771
200018521.0,CC du Val de Bouzanne,66,66,56,76,43,81,388
200018653.0,CA Cap Excellence,2626,2094,2164,2781,1660,4600,15925
200022986.0,CC du Grand Pic Saint-Loup,614,531,574,699,394,572,3384
200023075.0,CC du Pays de Maîche,286,200,221,254,108,171,1240
200023125.0,CC Les Portes Briardes entre Villes et Forêts,595,434,484,515,226,358,2612
200023240.0,CC Pays de Nemours,520,392,403,467,257,380,2419
200023299.0,CC Coeur de Tarentaise,246,115,177,103,43,27,711
200023307.0,CA du Grand Villeneuvois,1031,739,724,859,502,815,4670
200023372.0,CC de la Vallée de Chamonix-Mont-Blanc,330,160,184,161,65,91,991
200023414.0,Métropole Rouen Normandie,9946,7768,8001,9317,5060,9338,49430
200023620.0,CC de la Gascogne Toulousaine,295,184,168,241,114,192,1194
200023737.0,CA du Grand Cahors,856,559,636,827,443,738,4059
200023778.0,CC du Pays de Saint-Gilles-Croix-de-Vie,912,713,679,903,454,767,4428
200023794.0,CC de Blaye,409,301,358,420,228,407,2123
200023919.0,CC Gâtinais Val de Loing,299,255,246,299,134,236,1469
200026573.0,CC Haut-Jura Saint-Claude,313,246,256,318,141,213,1487
200027027.0,CC Arc Sud Bretagne,420,329,308,385,220,349,2011
200027076.0,CC Arnon Boischaut Cher,106,89,82,107,66,135,585
200027100.0,CC Méditerranée Porte des Maures,1117,594,598,820,421,698,4248
200027183.0,CU Perpignan Méditerranée Métropole,6374,4946,4960,6596,3391,5695,31962
200027217.0,CC Sarlat-Périgord Noir,461,237,232,327,150,251,1658
200027308.0,CC d'Auberive Vingeanne et Montsaugeonnais,97,85,92,120,51,89,534
200027548.0,CC des Savanes,993,786,641,546,247,315,3528
200029734.0,CC des 4B Sud Charente,275,249,262,307,170,308,1571
200029999.0,CC Rives de l'Ain - Pays du Cerdon,207,180,211,225,99,143,1065
200030195.0,Métropole Nice Côte d'Azur,12611,7941,8396,10041,4983,7760,51732
200030385.0,CA de Blois Agglopolys,1829,1384,1409,1754,971,1594,8941
200030435.0,CC d'Aire-sur-l'Adour,174,155,166,185,106,135,921
200030526.0,CC du Ried de Marckolsheim,258,182,215,280,126,205,1266
200030633.0,CA du Caudrésis et du Catésis,1240,1065,1120,1453,925,1549,7352
200030658.0,CC du Trièves,154,103,118,147,71,122,715
200030674.0,CA Val de Garonne Agglomération,1089,782,830,1082,545,962,5290
200032514.0,CC Berry-Loire-Vauvise,63,55,74,80,52,105,429
200033025.0,CA de Bar-le-Duc - Sud Meuse,522,346,363,523,280,525,2559
200033090.0,CC Plaines et Monts de France,278,234,206,256,109,161,1244
200033116.0,CC Cluses-Arve et Montagnes,961,735,844,939,455,620,4554
200033173.0,CC de la Haute Vallée de Chevreuse,259,154,182,210,96,144,1045
200033181.0,CA Chartres Métropole,2268,1696,1977,2226,1251,1946,11364
200033207.0,CC Vierzon-Sologne-Berry,699,521,601,680,393,754,3648
200033298.0,CC des Coëvrons,319,290,284,346,186,296,1721
200033579.0,CU d'Arras,1948,1377,1440,1740,1064,1701,9270
200033827.0,CC de Fium'orbu Castellu,392,184,139,169,67,92,1043
200033868.0,CC des Ballons des Hautes-Vosges,214,165,174,257,159,289,1258
200034023.0,CC Tarn-Agout,388,385,338,441,245,418,2215
200034031.0,CC des Monts d'Alban et du Villefranchois,73,66,64,87,44,53,387
200034049.0,CC Centre Tarn,153,104,131,155,82,143,768
200034056.0,CC du Lautrécois et du Pays d'Agout,210,182,180,222,119,184,1097
200034064.0,CC du Cordais et du Causse (4 C),68,51,60,86,41,91,397
200034098.0,CC des Montagnes du Giffre,196,135,167,176,110,139,923
200034130.0,CC Gally Mauldre,192,154,188,200,103,158,995
200034197.0,CC de Montaigne Montravel et Gurson,197,157,147,221,120,208,1050
200034205.0,CC de la Costa Verde,285,148,108,128,56,58,783
200034270.0,CC du Pays de Barr,312,234,276,344,159,254,1579
200034379.0,CC Pays d'Uzès,439,323,381,517,252,479,2391
200034411.0,CC du Piémont Cévenol,427,319,373,431,264,411,2225
200034601.0,CC Causses Aigoual Cévennes,107,83,77,135,78,110,590
200034635.0,CC du Kochersberg,225,162,204,233,128,199,1151
200034692.0,CA du Gard Rhodanien,1403,1100,1191,1472,762,1265,7193
200034700.0,CA Durance-Lubéron-Verdon Agglomération,1374,929,1034,1289,717,1090,6433
200034718.0,"CC de Vitry, Champagne et Der",401,299,347,384,236,410,2077
200034726.0,CC Bastides de Lomagne,133,105,107,143,68,112,668
200034825.0,CA du Grand Guéret,429,344,328,417,231,355,2104
200034833.0,CC des Bastides Dordogne-Périgord,266,233,182,258,153,239,1331
200034874.0,CC Côtes de Meuse Woëvre,79,54,59,82,44,86,404
200034882.0,CC Pays du Mont-Blanc,663,502,474,490,231,293,2653
200034957.0,CC du Frontonnais,410,262,357,347,226,325,1927
200035087.0,CA Terre de Provence,1208,795,891,1121,614,910,5539
200035103.0,CC de la Vallée de la Haute-Sarthe,82,89,66,97,47,83,464
200035111.0,CC des Sources de l'Orne,172,134,116,127,84,112,745
200035129.0,CC de Cèze Cévennes,417,277,320,496,287,441,2238
200035137.0,CC Marche Occitane - Val d'Anglin,64,59,71,110,46,64,414
200035202.0,CC Charlieu-Belmont,277,243,269,297,171,309,1566
200035319.0,CA Var Estérel Méditerranée (Cavem),2965,1804,1726,2123,1025,1515,11158
200035327.0,CC Cazals-Salviac,71,51,55,81,40,85,383
200035442.0,CC du Sud-Artois,370,262,339,440,246,368,2025
200035459.0,CA d'Agen,1797,1382,1450,1651,844,1363,8487
200035533.0,CC du Grand Saint-Émilionnais,252,159,176,303,142,214,1246
200035541.0,CC des Landes d'Armagnac,194,131,117,151,85,137,815
200035632.0,CC Armagnac Adour,95,63,88,82,50,88,466
200035665.0,CA Seine Eure,1320,1018,1035,1323,802,1425,6923
200035707.0,CC Piège Lauragais Malepère,245,186,207,253,138,229,1258
200035715.0,CA Carcassonne Agglo,2226,1517,1575,2196,1209,2200,10923
200035723.0,CC Ventoux Sud,193,128,147,186,96,155,905
200035731.0,CA Roannais Agglomération,1688,1298,1343,1662,945,1567,8503
200035756.0,CC Astarac Arros en Gascogne,95,69,74,75,40,60,413
200035764.0,CC de la Beauce Loirétaine,177,153,149,210,99,208,996
200035772.0,CC du Pays du Saintois,121,139,128,160,72,135,755
200035814.0,CA Flers Agglo,842,655,740,896,509,837,4479
200035848.0,CC du Châtillonnais en Berry,65,56,51,84,34,67,357
200035855.0,CC Castelnaudary Lauragais Audois,494,339,410,489,230,367,2329
200035863.0,"CC Région Lézignanaise, Corbières et Minervois",590,445,527,664,346,530,3102
200035970.0,CC Vexin Centre,266,228,233,250,118,240,1335
200036069.0,CC du Pays de Mortagne-au-Perche,200,127,141,156,85,137,846
200036077.0,CC du Golfe de Saint-Tropez,3293,928,743,1300,685,943,7892
200036135.0,CC Coeur de France,275,216,243,286,168,323,1511
200036150.0,CC des Hauts du Val de Saône,136,83,79,122,59,81,560
200036465.0,CC de Thann-Cernay,579,469,472,607,335,494,2956
200036473.0,CA de Saintes,1074,794,789,968,567,907,5099
200036499.0,CC de Marana-Golo,620,290,245,279,110,128,1672
200036523.0,CC des Bastides en Haut-Agenais Périgord,249,182,202,233,127,231,1224
200036549.0,CC Val de Gray,327,271,298,311,135,250,1592
200036572.0,CC Porte d'Aquitaine en Pays de Serres,69,51,75,90,42,60,387
200037059.0,CC de la Haute-Somme,463,345,428,588,384,711,2919
200037133.0,CC du Provinois,582,413,420,520,299,403,2637
200038958.0,CC de la Pieve de l'Ornano,346,141,124,139,78,72,900
200038990.0,CC de Saint-Méen Montauban,326,306,325,321,158,282,1718
200039022.0,CA Vitré Communauté,1213,977,954,1101,544,843,5632
200039055.0,CC Ouche et Montagne,133,79,101,117,71,148,649
200039063.0,"CC Forêts, Seine et Suzon",67,51,49,64,35,57,323
200039204.0,CC de Lacq-Orthez,749,580,603,798,414,736,3880
200039519.0,CC du Quercy Blanc,131,66,86,106,74,133,596
200039642.0,CC Le Tonnerrois en Bourgogne,186,177,167,237,145,224,1136
200039709.0,CC du Serein,64,54,60,71,43,76,368
200039758.0,"CC Avallon, Vézelay, Morvan",309,186,231,232,141,187,1286
200039808.0,CC des Gorges de l'Ardèche,527,321,268,400,278,426,2220
200039824.0,CC Ardèche des Sources et Volcans,205,156,160,188,122,207,1038
200039832.0,CC Pays des Vans en Cévennes,218,131,156,223,147,206,1081
200039857.0,CA du Pays de Grasse,2052,1423,1422,1708,843,1155,8603
200039865.0,Metz Métropole,4159,3308,3317,3711,2097,3519,20111
200039907.0,CC du Sud Messin,176,145,130,157,82,142,832
200039915.0,CA Cannes Pays de Lérins,4554,2783,2862,3335,1651,2676,17861
200039931.0,CC Alpes d'Azur,132,94,107,112,63,111,619
200039949.0,CC Rives de Moselle,783,616,644,771,442,778,4034
200040038.0,CC Saône Doubs Bresse,160,107,112,167,83,178,807
200040095.0,CC Isle Vern Salembre en Périgord,259,236,235,257,165,245,1397
200040111.0,CC Coeur de Chartreuse,206,159,183,206,121,154,1029
200040137.0,CC des Lacs de Champagne,125,107,90,137,64,142,665
200040178.0,CC de l'Outre-Forêt,194,147,161,179,120,174,975
200040202.0,CC Provence Verdon,394,274,365,419,211,316,1979
200040210.0,CC Lacs et Gorges du Verdon,200,89,135,155,83,128,790
200040244.0,CA du Bocage Bressuirais,1099,853,954,1017,556,881,5360
200040251.0,CC Bassée-Montois,348,238,282,347,180,217,1612
200040277.0,CA du Pays de Dreux,2194,1675,1857,2247,1172,1936,11081
200040293.0,CC du Clunisois,156,148,123,203,95,136,861
200040350.0,CC Bugey Sud,563,398,463,477,239,364,2504
200040384.0,CC Isle Double Landais,209,172,160,220,102,209,1072
200040392.0,CA Le Grand Périgueux,1866,1420,1417,1712,900,1430,8745
200040400.0,CC du Pays Ribéracois,239,235,224,273,156,229,1356
200040418.0,CC du Pays de Serres en Quercy,150,91,101,149,94,135,720
200040426.0,CC du Val de l'Oise,211,201,203,272,174,384,1445
200040442.0,CA Luberon Monts de Vaucluse,1355,844,1096,1300,705,1168,6468
200040459.0,CA Montélimar Agglomération,1355,1074,1134,1352,728,1065,6708
200040475.0,CC Loué - Brûlon - Noyen,247,198,189,264,152,209,1259
200040491.0,CC Porte de Drômardèche,808,737,706,920,493,755,4419
200040509.0,CC du Crestois et de Pays de Saillans Coeur de Drôme,380,294,308,442,227,354,2005
200040558.0,CC Écueillé-Valençay,142,82,84,127,75,134,644
200040566.0,CA de l'Ouest Rhodanien,673,572,673,751,368,614,3651
200040574.0,CC Beaujolais Pierres Dorées,546,487,484,591,272,358,2738
200040590.0,CA Villefranche Beaujolais Saône,1314,1080,1121,1207,647,896,6265
200040624.0,CC Pays d'Apt-Luberon,728,411,435,624,328,467,2993
200040657.0,CC de la Matheysine,261,214,202,244,120,200,1241
200040681.0,CC Enclave des Papes-Pays de Grignan,384,301,362,419,276,467,2209
200040715.0,Métropole Grenoble-Alpes-Métropole,8149,6101,5946,6645,3393,5131,35365
200040764.0,CC du Sud Corse,2048,386,153,157,53,53,2850
200040772.0,CC du Perche et Haut Vendômois,98,77,91,113,71,111,561
200040798.0,CC Val Vanoise,135,78,126,71,28,26,464
200040814.0,CC Briance Sud Haute Vienne,95,86,90,107,61,115,554
200040830.0,CC du Pays de Fénelon,206,140,130,155,80,134,845
200040889.0,CC de Portes Sud Périgord,109,99,90,131,75,107,611
200040905.0,CC Carmausin-Ségala,479,369,455,552,305,452,2612
200040947.0,CC de Flandre Intérieure,1300,1038,1122,1365,721,1101,6647
200040954.0,CC des Hauts de Flandre,618,527,580,700,414,705,3544
200041010.0,CC Coeur de Savoie,540,418,392,507,246,325,2428
200041051.0,CC Vallée de la Dordogne et Forêt Bessède,184,100,111,160,65,113,733
200041150.0,CC du Terrassonnais en Périgord Noir Thenon Hautefort,349,269,287,343,177,270,1695
200041168.0,CC de la Vallée de l'Homme,368,213,177,275,156,199,1388
200041283.0,CC de la Plaine du Rhin,180,101,152,159,91,156,839
200041317.0,CA du Niortais,1885,1442,1429,1638,871,1501,8766
200041325.0,CC du Pays Rhénan,382,276,322,429,237,412,2058
200041333.0,CC de Parthenay-Gâtine,519,410,430,517,291,523,2690
200041366.0,CC Rhône Crussol,471,393,404,480,250,398,2396
200041416.0,CC Airvaudais-Val du Thouet,102,54,70,79,46,81,432
200041440.0,CC de Domme - Villefranche du Périgord,193,122,112,152,74,102,755
200041465.0,CC Val Eyrieux,132,118,110,196,89,204,849
200041499.0,CC Aunis Atlantique,507,391,400,531,274,376,2479
200041507.0,CA La Riviera du Levant,1509,1340,1363,1857,1087,2924,10080
200041515.0,CC du Bassin de Pont-à-Mousson,609,471,493,613,376,548,3110
200041523.0,CC de la Haute-Saintonge,1112,894,926,1188,658,1108,5886
200041556.0,CC Portes de la Creuse en Marche,83,62,78,102,52,82,459
200041572.0,CC Dronne et Belle,140,115,136,166,89,132,778
200041614.0,CC Aunis Sud,507,423,427,544,291,490,2682
200041622.0,CC Ardennes Thiérache,150,113,119,165,78,152,777
200041630.0,CA Ardenne Métropole,2252,1650,1926,2415,1376,2809,12428
200041689.0,CC des Vals de Saintonge,801,699,745,1081,574,957,4857
200041721.0,CC de la Haute Comté,271,184,208,292,153,253,1361
200041762.0,CA Rochefort Océan,1158,898,1000,1185,661,1083,5985
200041788.0,CA du Pays Nord Martinique,2224,1813,2059,2616,1504,3242,13458
200041853.0,CC du Pays de Montbozon et du Chanois,81,47,52,67,36,66,349
200041861.0,CC du Triangle Vert,153,96,132,131,77,109,698
200041879.0,CC Terres de Saône,184,141,130,159,88,132,834
200041887.0,CC du Val Marnaysien,164,114,126,186,86,127,803
200041960.0,CC Pévèle-Carembault,1044,856,895,1119,637,1084,5635
200041994.0,CC Haut Val de Sèvre,342,294,313,353,218,370,1890
200042000.0,CC Bruyères-Vallons des Vosges,213,160,205,227,134,242,1181
200042174.0,CA Lorient Agglomération,3420,2696,2657,3314,1753,3014,16854
200042182.0,CC du Mont des Avaloirs,197,167,136,188,121,173,982
200042190.0,CA de la Porte du Hainaut,3109,2516,2801,3556,2127,3619,17728
200042372.0,CC des Coteaux Arrats Gimone,136,97,94,124,65,111,627
200042414.0,CC Bresse Revermont 71,121,93,93,144,59,91,601
200042463.0,CC de la Montagne Noire,98,68,79,101,79,119,544
200042497.0,CC Dombes Saône Vallée,506,400,387,425,183,207,2108
200042604.0,"CC de Granville, Terre et Mer",709,560,533,641,357,545,3345
200042620.0,CC de la Région de Suippes,80,75,69,87,51,78,440
200042646.0,CC Grand Orb,392,266,300,414,215,392,1979
200042653.0,CC Sud-Hérault,316,241,283,375,208,328,1751
200042703.0,CC de l'Argonne Champenoise,165,92,102,168,87,157,771
200042729.0,CC de la Baie du Cotentin,314,230,253,338,178,249,1562
200042901.0,CC Drôme Sud Provence,832,652,721,790,528,753,4276
200042935.0,CA Haut - Bugey Agglomération,1196,976,1035,1082,537,768,5594
200042943.0,CC du Cap Corse,212,77,65,83,31,37,505
200042992.0,CC Perthois-Bocage et Der,64,36,51,75,36,65,327
200043016.0,CC Val de Charente,244,170,189,225,124,226,1178
200043065.0,CC du Val d'Amboise,568,434,381,574,301,493,2751
200043081.0,"CC Chinon, Vienne et Loire",432,357,323,418,195,380,2105
200043123.0,CC Auray Quiberon Terre Atlantique,1760,1140,1170,1466,815,1288,7639
200043156.0,CC du Pays Rethélois,429,365,353,426,247,395,2215
200043172.0,CA du Bassin de Brive,1700,1341,1489,1698,895,1457,8580
200043263.0,CC Coeur de l'Avesnois,492,453,407,574,349,639,2914
200043321.0,CC du Pays de Mormal,641,501,535,699,431,716,3523
200043354.0,CC de Villedieu Intercom,192,207,161,195,97,187,1039
200043396.0,CA Maubeuge Val de Sambre,2755,2222,2438,2810,1772,2814,14811
200043404.0,CC du Sud Avesnois,511,384,463,626,391,638,3013
200043438.0,CC de la Moivre à la Coole,92,73,81,81,50,83,460
200043495.0,CA du Pays de Laon,876,640,776,876,511,991,4670
200043602.0,"CC des Albères, de la Côte Vermeille et de l'Illibéris",1706,1026,998,1443,744,1212,7129
200043628.0,CC des Vallées du Clain,227,213,216,315,140,241,1352
200043693.0,CC Terre Lorraine du Longuyonnais,166,137,154,188,108,167,920
200043776.0,CC Pyrénées Audoises,234,144,180,247,150,244,1199
200043974.0,CC du Sud Gironde,811,655,612,794,458,753,4083
200043982.0,CC du Bazadais,218,216,225,307,139,271,1376
200043990.0,CC Vallons de Haute-Bretagne Communauté,572,514,529,653,306,557,3131
200044014.0,CC Creuse Grand Sud,168,129,179,196,129,215,1016
200044030.0,CC des Sept Vallées,391,352,387,449,257,399,2235
200044048.0,CC Osartis Marquion,530,446,534,629,391,597,3127
200044253.0,CC du Bassin de Joinville en Champagne,194,137,143,185,138,211,1008
200044394.0,CC du Réolais en Sud Gironde,456,310,363,481,293,410,2313
200044469.0,CC du Pays de Mirepoix,189,138,150,218,102,158,955
200044618.0,CA du Douaisis (C.A.D.),3255,2485,2525,3227,2070,3391,16953
200044691.0,CA du Nord Grande Terre,1195,1210,1156,1577,925,3011,9074
200046977.0,Métropole de LYON,10517,8364,8011,9155,4546,7175,47768
200046977.0,Métropole de Lyon,16785,13235,13825,15479,7751,11425,78500
200048551.0,CC du Pays de Craon,350,260,259,341,151,290,1651
200049187.0,CA du Grand Verdun,490,365,364,408,258,464,2349
200049211.0,CC Conflent-Canigó,490,337,356,472,263,419,2337
200049484.0,CC Berry Grand Sud,163,116,128,161,114,181,863
200054781.0,Métropole du Grand Paris,123143,93004,101849,118116,61611,113254,610977
200054807.0,Métropole d'Aix-Marseille-Provence,38210,28361,31295,37084,19218,30538,184706
200055481.0,CC Beauce Val de Loire,269,204,232,269,148,276,1398
200055655.0,CA Roissy Pays de France,7278,5460,5773,6378,3292,4828,33009
200055887.0,CC Mayenne Communauté,499,400,384,406,217,343,2249
200056232.0,CA Communauté Paris-Saclay,4523,3361,3305,3706,1687,2490,19072
200056380.0,CA Plaine Vallée,2812,2146,2303,2462,1209,1783,12715
200057859.0,CA Coeur d'Essonne Agglomération,3208,2343,2519,2604,1173,1681,13528
200057958.0,CA Paris - Vallée de la Marne,3872,2737,2927,3280,1520,2253,16589
200058360.0,CC Entre Beauce et Perche,238,192,226,266,148,226,1296
200058477.0,CA Val d'Yerres Val de Seine,2832,2096,2225,2514,1163,1651,12481
200058485.0,CA Val Parisis,4198,3247,3315,3784,1807,2912,19263
200058519.0,CA Saint-Germain Boucles de Seine,4403,3377,3441,4002,2001,3159,20383
200058782.0,CA de Saint-Quentin-en-Yvelines,3597,2739,2798,3188,1678,2223,16223
200059228.0,CA Grand Paris Sud Seine Essonne Sénart,7131,5103,5463,5673,2628,3548,29546
200059392.0,CC Bièvre Isère,789,621,621,755,413,531,3730
200059400.0,CC Porte Océane du Limousin,366,265,338,358,204,339,1870
200059889.0,CU Grand Paris Seine et Oise,7885,6046,6323,7530,3927,5754,37465
200060010.0,CA Mauges Communauté,1549,1264,1330,1601,814,1359,7917
200065563.0,CC Normandie-Cabourg-Pays d'Auge,525,377,381,497,251,402,2433
200065589.0,CC Val ès Dunes,265,194,189,264,151,232,1295
200065597.0,CU Caen la Mer,5429,4205,4034,4923,2582,4271,25444
200065647.0,CA Pays de Montbéliard Agglomération,2524,2031,2268,2759,1407,2189,13178
200065787.0,CC de Pont-Audemer / Val de Risle,512,435,472,555,327,564,2865
200065886.0,CA Loire Forez Agglomération,1451,1177,1277,1441,788,1182,7316
200065894.0,CC de Forez-Est,780,598,671,759,381,586,3775
200065928.0,CA Lannion-Trégor Communauté,1616,1134,1210,1431,775,1363,7529
200066009.0,CA Mulhouse Alsace Agglomération,6056,4323,4650,5309,2681,4341,27360
200066017.0,CC Lieuvin Pays d'Auge,265,183,225,335,183,287,1478
200066025.0,CC Pays Rhin - Brisach,347,279,314,401,195,328,1864
200066033.0,CC Sud Alsace Largue,332,212,236,297,123,203,1403
200066041.0,CC Sundgau,624,480,525,561,285,425,2900
200066058.0,CA Saint-Louis Agglomération,1320,986,1044,1120,582,797,5849
200066108.0,CC des Portes de Meuse,203,169,167,205,114,231,1089
200066116.0,CC Argonne-Meuse,84,62,73,73,45,69,406
200066124.0,CA Gaillac-Graulhet,1274,998,1076,1399,750,1296,6793
200066132.0,CC du Pays de Stenay et du Val Dunois,138,106,112,151,68,122,697
200066140.0,CC de l'Aire à l'Argonne,77,55,56,69,30,67,354
200066157.0,CC de Commercy - Void - Vaucouleurs,380,256,306,361,197,376,1876
200066165.0,CC Val de Meuse - Voie Sacrée,110,85,78,122,56,109,560
200066173.0,CC de Damvillers Spincourt,108,74,81,95,64,87,509
200066223.0,CC Arize Lèze,158,121,175,219,127,191,991
200066231.0,CC des Portes d'Ariège Pyrénées,792,608,676,765,330,506,3677
200066280.0,CC du Pithiverais,510,386,430,548,292,434,2600
200066322.0,CC Terres des Confluences,1047,690,828,1088,614,992,5259
200066330.0,CC Terres du Haut Berry,299,256,261,317,192,335,1660
200066348.0,CC du Minervois au Caroux,273,178,199,311,163,325,1449
200066355.0,CA Sète Agglopôle Méditerranée,2841,1957,1998,2764,1591,2581,13732
200066363.0,CC de la Haute Ariège,125,96,100,147,78,113,659
200066371.0,CC Causses et Vallée de la Dordogne,811,564,579,801,391,628,3774
200066389.0,CA Saint-Lô Agglo,1077,900,848,1030,526,794,5175
200066405.0,CC Roumois Seine,428,350,400,518,290,494,2480
200066413.0,CC Intercom Bernay Terres de Normandie,746,673,722,920,497,1024,4582
200066462.0,CC Interco Normandie Sud Eure,570,455,495,592,337,643,3092
200066512.0,CC Élan Limousin Avenir Nature,312,283,299,379,222,346,1841
200066520.0,CC Ouest Limousin,132,91,132,156,72,152,735
200066553.0,CC des Monts de Lacaune et de la Montagne du Haut Languedoc,105,64,76,110,51,106,512
200066561.0,CC Sidobre Vals et Plateaux,170,151,152,186,119,166,944
200066587.0,CC des Monts du Lyonnais,375,311,312,357,196,292,1843
200066603.0,CC du Pays de Lubersac-Pompadour,111,76,86,104,46,86,509
200066637.0,CC Hautes Terres Communauté,155,115,85,121,50,67,593
200066645.0,CC Vézère-Monédières-Millesources,66,27,39,62,34,36,264
200066652.0,CC Grand Sud Tarn et Garonne,734,541,622,741,434,554,3626
200066660.0,CC Saint-Flour Communauté,323,195,184,183,91,112,1088
200066678.0,CC de la Châtaigneraie Cantalienne,227,149,158,219,106,156,1015
200066710.0,CC Cingal-Suisse Normande,325,333,270,378,213,321,1840
200066728.0,CC Vallées de l'Orne et de l'Odon,296,236,238,302,146,265,1483
200066744.0,CC Haute-Corrèze Communauté,423,314,333,404,198,264,1936
200066751.0,CC Xaintrie Val'Dordogne,148,95,112,128,71,129,683
200066769.0,CC Midi Corrézien,164,128,150,185,83,161,871
200066777.0,CC Ploërmel Communauté,612,544,587,698,374,478,3293
200066785.0,CC de l'Oust à Brocéliande,494,482,457,587,297,482,2799
200066793.0,CA du Grand Annecy,3515,2526,2592,2694,1154,1551,14032
200066801.0,CC Isigny-Omaha Intercom,412,266,280,332,191,323,1804
200066819.0,CC du Volvestre,444,358,438,518,259,491,2508
200066827.0,CC du Pays de Honfleur-Beuzeville,548,351,362,444,245,327,2277
200066835.0,CC de Sézanne-Sud Ouest Marnais,340,227,272,335,186,275,1635
200066850.0,CC des Paysages de la Champagne,253,225,211,272,154,227,1342
200066868.0,CC Presqu'île de Crozon-Aulne maritime,359,273,274,423,224,370,1923
200066876.0,CA de Châlons-en-Champagne,1419,954,1095,1245,703,1122,6538
200066884.0,CC Quercy Vert-Aveyron,368,273,316,426,221,313,1917
200066892.0,CC de Vendeuvre-Soulaines,114,64,92,153,77,136,636
200066918.0,CA Alès Agglomération,2509,2028,2229,2974,1563,2882,14185
200066926.0,CA Grand Auch Coeur de Gascogne,674,454,474,520,249,383,2754
200066975.0,CC Senlis Sud Oise,332,217,266,267,154,249,1485
200067023.0,CC Coutances Mer et Bocage,692,509,559,598,334,513,3205
200067031.0,CC Côte Ouest Centre Manche,309,248,285,310,161,241,1554
200067049.0,CC Spelunca-Liamone,427,75,63,104,39,46,754
200067064.0,CC Decazeville Communauté,285,210,218,272,148,172,1305
200067072.0,CC Haut-Léon Communauté,493,339,380,545,256,533,2546
200067080.0,"CC Chablis, Villages et Terroirs",147,164,141,160,92,163,867
200067106.0,CA du Pays Basque,6081,4028,4136,5112,2558,3774,25689
200067114.0,CA de l'Auxerrois,1089,887,833,904,500,857,5070
200067122.0,CC Coteaux et Plaines du Pays Lafrançaisain,193,136,165,183,99,163,939
200067130.0,CC de Puisaye-Forterre,422,356,400,443,224,396,2241
200067155.0,"CC Saint Affricain, Roquefort, Sept Vallons",188,132,149,208,110,165,952
200067163.0,"CC Monts, Rance et Rougier",62,65,74,79,52,66,398
200067171.0,"CC Aubrac, Carladez et Viadène",109,58,59,77,36,72,411
200067189.0,CC Creuse Sud Ouest,166,137,168,188,116,167,942
200067197.0,CC Monts d'Arrée Communauté,114,92,108,145,79,140,678
200067205.0,CA du Cotentin,2667,1930,1869,2211,1139,2052,11868
200067213.0,CU du Grand Reims,5202,3918,4169,4858,2799,4819,25765
200067221.0,CC Centre Morbihan Communauté,625,515,545,625,341,509,3160
200067239.0,CC des Luys en Béarn,334,253,312,376,208,306,1789
200067247.0,CC Pleyben-Châteaulin-Porzay,309,279,265,401,191,308,1753
200067254.0,CA Pau Béarn Pyrénées,2801,2270,2302,2612,1509,2238,13732
200067262.0,CC du Haut-Béarn,730,370,420,458,252,382,2612
200067288.0,CC du Béarn des Gaves,240,182,179,254,127,197,1179
200067296.0,CC du Nord Est Béarn,406,328,346,412,254,334,2080
200067304.0,CC Serein et Armance,365,281,335,363,190,329,1863
200067320.0,CC Serre-Ponçon Val d'Avance,121,118,124,130,65,105,663
200067346.0,CA Pornic Agglo Pays de Retz,931,724,759,995,513,800,4722
200067361.0,CC Grand-Figeac,666,473,506,638,269,357,2909
200067379.0,CC Côtes de Champagne et Val de Saulx,158,112,135,193,98,151,847
200067429.0,CC Haut Nivernais-Val d'Yonne,154,101,125,144,95,141,760
200067437.0,CA Provence-Alpes-Agglomération,915,680,717,956,506,809,4583
200067445.0,CC Buëch-Dévoluy,155,121,147,186,88,160,857
200067452.0,CC du Guillestrois et du Queyras,176,108,146,214,134,190,968
200067460.0,CC Loudéac Communauté - Bretagne Centre,889,593,685,690,368,561,3786
200067478.0,CC Comtal Lot et Truyère,198,142,163,195,112,160,970
200067486.0,CC Bouzonvillois-Trois Frontières,270,221,259,242,164,246,1402
200067502.0,CA Saint-Avold Synergie,910,727,791,889,548,855,4720
200067510.0,CC Monts et Vallées Ouest Creuse,301,240,261,285,146,243,1476
200067544.0,CC Creuse Confluence,244,184,176,217,134,212,1167
200067551.0,CA Thonon Agglomération,1739,1234,1318,1347,548,671,6857
200067593.0,CC Marche et Combraille en Aquitaine,156,101,141,195,104,165,862
200067627.0,CC Billom Communauté,289,243,323,352,223,345,1775
200067635.0,CA Clisson Sèvre et Maine Agglo,696,585,584,698,357,638,3558
200067643.0,"CC Meurthe, Mortagne, Moselle",192,159,168,219,133,251,1122
200067650.0,CC Houve-Pays Boulageois,276,218,235,265,152,268,1414
200067668.0,"CC de la Cléry, du Betz et de l'Ouanne",328,240,287,336,184,314,1689
200067676.0,CC Canaux et Forêts en Gâtinais,383,324,348,456,215,442,2168
200067684.0,"CA Épernay, Coteaux et Plaine de Champagne",813,637,607,782,428,743,4010
200067692.0,CC Tannay-Brinon-Corbigny,100,76,80,123,51,110,540
200067700.0,CC Sud Nivernais,249,204,204,269,132,250,1308
200067742.0,CC Serre-Ponçon,329,267,286,341,202,302,1727
200067759.0,CC Vallées et Plateau d'Ardenne,396,311,332,420,282,455,2196
200067767.0,CC du Royans-Vercors,136,127,121,192,91,147,814
200067783.0,CC de Hanau-La Petite Pierre,331,227,293,322,162,293,1628
200067791.0,CA Pays Foix-Varilhes,595,430,434,618,286,394,2757
200067817.0,CC Saône-Beaujolais,659,483,540,582,273,428,2965
200067825.0,CA Gap-Tallard-Durance,924,664,709,748,419,621,4085
200067841.0,CC de l'Alsace Bossue,311,255,254,336,166,306,1628
200067866.0,CC Sèvre et Loire,635,547,505,660,295,570,3212
200067874.0,CA de Haguenau,1420,1073,1195,1389,671,1196,6944
200067882.0,CC Bazois Loire Morvan,179,104,142,146,98,191,860
200067890.0,CC Morvan Sommets et Grands Lacs,128,108,108,150,86,144,724
200067908.0,CC Amognes Coeur du Nivernais,92,74,90,89,57,90,492
200067916.0,"CC Loire, Vignobles et Nohain",326,268,298,343,197,325,1757
200067924.0,CC du Canton d'Erstein,583,398,536,546,312,517,2892
200067932.0,CA Golfe du Morbihan - Vannes Agglomération,2787,2187,2186,2662,1403,2064,13289
200067940.0,CC Couserans-Pyrénées,589,428,518,666,400,572,3173
200067957.0,CC Haut Chemin-Pays de Pange,186,139,136,182,108,149,900
200067965.0,CA de la Région de Compiègne et de la Basse Automne,1451,1086,1204,1339,758,1282,7120
200067973.0,CC Thelloise,768,609,696,826,454,650,4003
200067981.0,CA Guingamp-Paimpol Agglomération de l'Armor à l'Argoat,1190,919,1004,1210,661,1130,6114
200067999.0,CA du Beauvaisis,2061,1581,1618,1895,1047,1751,9953
200068005.0,CC de l'Oise Picarde,279,217,284,365,201,369,1715
200068047.0,CA Creil Sud Oise,2208,1539,1663,1770,955,1487,9622
200068070.0,CC Loue-Lison,331,203,258,299,157,212,1460
200068088.0,CC Les Bertranges,233,176,194,223,149,221,1196
200068096.0,CC Champsaur-Valgaudemar,173,122,170,223,104,207,999
200068104.0,CA de la Provence Verte,1805,1544,1470,1717,903,1345,8784
200068112.0,CC du Pays de Saverne,520,421,411,469,233,409,2463
200068120.0,CA Quimper Bretagne Occidentale,1734,1392,1415,1693,908,1386,8528
200068146.0,CC Sarrebourg Moselle Sud,715,507,502,600,318,451,3093
200068229.0,CC des Baronnies en Drôme Provençale,431,309,392,409,271,458,2270
200068278.0,CC Berry Loire Puisaye,266,241,240,314,164,307,1532
200068294.0,CC des Deux Vallées Vertes,199,140,212,241,122,208,1122
200068369.0,CC de Mirecourt Dompaire,235,194,210,206,126,261,1232
200068377.0,CC de la Porte des Vosges Méridionales,462,370,384,505,294,555,2570
200068435.0,CC Coeur du Perche,125,123,123,132,87,131,721
200068443.0,CC Andaine - Passais,191,135,142,163,85,137,853
200068450.0,CC Argentan Intercom,497,402,418,506,260,394,2477
200068468.0,CC des Pays de L'Aigle,426,306,318,427,220,310,2007
200068484.0,CC des Causses à l'Aubrac,178,139,146,160,88,121,832
200068500.0,CA de Cambrai,1500,1149,1318,1630,1032,1783,8412
200068534.0,CC Terroir de Caux,408,344,423,531,328,610,2644
200068542.0,CC Les Balcons du Dauphiné,1064,871,934,1117,518,678,5182
200068559.0,CC de l'Ouest Vosgien,323,249,248,345,194,369,1728
200068567.0,CC Les Vals du Dauphiné,950,716,851,879,435,607,4438
200068625.0,CC Alpes-Provence-Verdon - Sources de Lumière,246,115,149,210,97,208,1025
200068641.0,CA Le Muretain Agglo,1961,1660,1702,2028,978,1688,10017
200068658.0,"CA de Chaumont, du Bassin Nogentais et du Bassin de Bologne Vignory Froncles",716,536,530,625,330,480,3217
200068666.0,CA de Saint-Dizier Der et Blaise,920,734,808,914,603,1060,5039
200068674.0,CA Grand Lac,1346,851,942,1125,524,638,5426
200068682.0,CC Terre d'Eau,352,200,204,289,177,348,1570
200068757.0,CA d'Épinal,1814,1412,1496,1755,1012,1740,9229
200068765.0,CC du Sisteronais-Buëch,428,307,358,460,266,446,2265
200068773.0,CC des Vosges côté Sud Ouest,159,123,144,145,75,183,829
200068781.0,CA Valence Romans Agglo,4285,3362,3705,4346,2345,3764,21807
200068799.0,CC Intercom de la Vire au Noireau,720,550,601,704,423,664,3662
200068807.0,CC Bassin Auterivain Haut-Garonnais,479,421,428,497,276,457,2558
200068815.0,CC Coeur de Garonne,530,383,454,558,295,511,2731
200068831.0,CC Pays Ségali,171,164,164,194,109,157,959
200068856.0,CC des Hauts du Perche,131,69,93,140,67,90,590
200068864.0,CC de la Mossig et du Vignoble,256,239,239,300,135,252,1421
200068872.0,CC Éguzon - Argenton - Vallée de la Creuse,289,244,246,255,173,292,1499
200068880.0,CC Champagne Boischauts,106,107,91,134,79,115,632
200068914.0,CC La Rochefoucauld - Porte du Périgord,274,223,248,297,186,328,1556
200068922.0,CC du Confluent et des Coteaux de Prayssas,346,272,339,375,249,484,2065
200068930.0,CC Fumel Vallée du Lot,365,265,327,402,238,427,2024
200068948.0,CC Albret Communauté,401,293,342,472,267,485,2260
200068955.0,CC Anjou Loir et Sarthe,391,326,360,467,258,509,2311
200068963.0,CC Maine Coeur de Sarthe,224,194,189,275,127,250,1259
200068989.0,CA Dinan Agglomération,1544,1188,1292,1518,849,1370,7761
200068997.0,CA Arlysère,1109,668,757,642,271,348,3795
200069003.0,CC du Barséquanais en Champagne,251,182,220,274,175,344,1446
200069029.0,CA des Deux Baies en Montreuillois,1173,795,761,1005,620,994,5348
200069037.0,CA du Pays de Saint-Omer,1660,1311,1396,1806,1093,1904,9170
200069052.0,CA Grand Belfort,2008,1518,1631,1789,861,1507,9314
200069060.0,CC des Vosges du Sud,190,141,164,197,81,159,932
200069086.0,CC Leff Armor Communauté,444,365,376,492,264,438,2379
200069094.0,CC Isle et Crempse-en-Périgord,225,153,170,215,118,206,1087
200069102.0,CC Randon - Margeride,50,34,44,46,34,27,235
200069110.0,CA du Grand Chambéry,2385,1745,1755,1894,956,1352,10087
200069128.0,CC Mont Lozère,88,50,61,74,40,70,383
200069136.0,CC des Cévennes au Mont Lozère,81,44,58,100,47,71,401
200069144.0,CC des Hautes Terres de l'Aubrac,47,33,32,40,26,34,212
200069151.0,CC Gorges Causses Cévennes,164,81,73,111,58,90,577
200069169.0,CC Dômes Sancy Artense,131,93,110,174,99,146,753
200069177.0,CC Mond'Arverne Communauté,434,352,398,471,263,448,2366
200069185.0,CC des Terres d'Apcher-Margeride-Aubrac,134,68,93,115,57,76,543
200069193.0,CC de la Dombes,510,356,396,412,195,235,2104
200069227.0,CC Pays Fort Sancerrois Val de Loire,246,185,205,240,138,217,1231
200069235.0,CC du Haut Pays du Montreuillois,228,138,169,190,111,178,1014
200069250.0,CA Troyes Champagne Métropole,3604,2618,2926,3536,1936,3395,18015
200069268.0,CC Aubrac Lot Causses Tarn,114,73,76,91,67,43,464
200069300.0,CA Tarbes-Lourdes-Pyrénées,3927,1672,1816,2315,1229,1911,12870
200069383.0,CC du Grand Villefranchois,433,301,311,348,195,292,1880
200069391.0,CA de Lamballe Terre et Mer,958,773,762,910,471,727,4601
200069409.0,CA Saint-Brieuc Armor Agglomération,2602,2102,2138,2560,1421,2326,13149
200069417.0,CC Pays d'Orthe et Arrigans,406,304,318,433,228,392,2081
200069425.0,CA Mont-Saint-Michel-Normandie,1269,847,908,1047,529,889,5489
200069433.0,CC de Vezouze en Piémont,192,115,130,181,106,233,957
200069441.0,CC du Pays de Bitche,422,309,326,461,274,438,2230
200069458.0,CC des Vallées d'Auge et du Merlerault,213,169,185,203,109,189,1068
200069482.0,CC des Campagnes de l'Artois,374,303,304,415,242,398,2036
200069516.0,CC Seulles Terre et Mer,220,162,143,169,81,135,910
200069524.0,CC Pré-Bocage Intercom,342,304,265,391,197,310,1809
200069532.0,CA Lisieux Normandie,1324,891,976,1133,629,931,5884
200069540.0,CC Norge et Tille,146,103,106,146,57,121,679
200069565.0,CC des Lacs et Montagnes du Haut-Doubs,283,194,220,236,109,131,1173
200069581.0,CC Convergence Garonne,541,441,476,592,274,533,2857
200069599.0,CC Rurales de l'Entre-deux-Mers,234,223,205,301,141,287,1391
200069615.0,CC Bresse Haute Seille,230,181,175,249,110,123,1068
200069623.0,CC Champagnole Nozeroy Jura,281,252,260,281,110,185,1369
200069631.0,CC Terres de Chalosse,291,208,205,282,167,235,1388
200069649.0,CC Chalosse Tursan,330,271,280,327,201,348,1757
200069656.0,CC Coeur Haute Lande,328,269,258,335,182,295,1667
200069664.0,CC Meuse Rognon,129,99,85,128,75,104,620
200069672.0,CC du Ternois,526,387,432,572,330,406,2653
200069698.0,CC Mâconnais - Tournugeois,255,205,217,267,131,241,1316
200069722.0,CC Interrégionale Aumale - Blangy-sur-Bresle,283,251,284,349,208,355,1730
200069730.0,CC des Quatre Rivières,403,331,305,449,274,463,2225
200069748.0,CC Val de Gâtine,310,211,216,279,155,268,1439
200069755.0,CC Mellois-en-Poitou,614,430,413,558,325,513,2853
200069763.0,CC du Haut-Poitou,494,481,469,514,294,524,2776
200069821.0,CA Fécamp Caux Littoral Agglomération,618,510,519,690,428,657,3422
200069839.0,CC de la Côte d'Albâtre,358,247,275,405,263,502,2050
200069847.0,CC Plateau de Caux-Doudeville-Yerville,297,202,245,338,163,325,1570
200069854.0,CU du Grand Poitiers,3110,2476,2371,2747,1420,2323,14447
200069912.0,CC des Forêts du Perche,97,92,80,128,76,113,586
200069953.0,CC des Portes Euréliennes d'Île-de-France,627,469,531,683,324,526,3160
200069961.0,CC du Grand Châteaudun,575,454,506,583,295,556,2969
200069995.0,CC Médoc Coeur de Presqu'île,663,486,477,655,383,576,3240
200070035.0,CC du Civraisien en Poitou,299,269,271,361,168,296,1664
200070043.0,CC Vienne et Gartempe,465,388,382,463,294,360,2352
200070068.0,CC Communauté Bray-Eawy,284,239,255,320,177,329,1604
200070092.0,CA du Libournais,1815,1426,1462,1861,948,1807,9319
200070100.0,CC du Val de Sully,345,279,272,357,195,361,1809
200070118.0,CC Val de Saône Centre,270,213,244,223,103,128,1181
200070126.0,CC Seine et Aube,148,115,116,131,92,157,759
200070142.0,CC Lyons Andelle,279,235,248,326,210,386,1684
200070159.0,CC Coeur de Beauce,319,275,277,381,171,311,1734
200070167.0,CC Terres de Perche,195,170,203,253,131,221,1173
200070183.0,CC des Terres du Val de Loire,628,483,580,677,317,591,3276
200070233.0,"CC Terres-de-Montaigu, communauté de communes Montaigu-Rocheservière",607,514,505,645,294,424,2989
200070282.0,CC Lavalette Tude Dronne,184,168,193,238,144,251,1178
200070290.0,CC Coeur du Pays Haut,292,230,246,283,184,317,1552
200070308.0,CA Mâconnais Beaujolais Agglomération,1447,1165,1279,1481,743,1061,7176
200070316.0,"CC Entre Arroux, Loire et Somme",263,209,226,312,161,305,1476
200070324.0,CC du Territoire de Lunéville à Baccarat,625,511,538,664,411,806,3555
200070332.0,CC des Savoir-Faire,224,143,170,182,130,176,1025
200070340.0,CC Haute-Maurienne Vanoise,126,70,111,89,33,49,478
200070365.0,CC Corbières Salanque Méditerranée,446,333,373,490,294,408,2344
200070373.0,CC Loir-Lucé-Bercé,399,302,329,394,202,421,2047
200070407.0,CA Pays d'Issoire,771,675,799,1017,600,975,4837
200070431.0,CC Saint-Marcellin Vercors Isère Communauté,625,574,518,706,397,586,3406
200070449.0,CC Inter-Caux-Vexin,535,445,460,599,341,568,2948
200070464.0,CC Coeur de Maurienne Arvan,244,152,199,158,81,111,945
200070506.0,CC Pays de Nexon Monts de Chalus,143,101,127,153,94,126,744
200070514.0,CA du Grand Cognac,1113,904,999,1175,696,1138,6025
200070530.0,CC du Grand Autunois Morvan,503,400,437,589,331,660,2920
200070548.0,CC La Clayette Chauffailles en Brionnais,161,134,148,199,85,173,900
200070555.0,CC de la Veyle,314,198,215,285,123,204,1339
200070563.0,CC Terres Touloises,648,553,508,596,342,560,3207
200070571.0,CC Coeur de Berry,103,72,88,110,68,116,557
200070589.0,CC de Seille et Grand Couronné,176,160,155,202,108,178,979
200070647.0,CA Bergeracoise,1214,882,941,1063,593,961,5654
200070662.0,CC Bretagne porte de Loire Communauté,443,332,329,411,229,335,2079
200070670.0,CC du Pays de Dol et de la Baie du Mont-Saint-Michel,360,254,275,319,184,289,1681
200070688.0,CC Couesnon Marches de Bretagne,288,221,257,253,126,259,1404
200070712.0,CC Thiers Dore et Montagne,656,510,604,760,453,792,3775
200070720.0,CC Médoc Atlantique,717,444,432,578,337,597,3105
200070738.0,CC Mad et Moselle,193,179,247,257,120,218,1214
200070746.0,CA Sarreguemines Confluences,972,745,848,1006,559,929,5059
200070753.0,CA Riom Limagne et Volcans,858,718,763,874,530,918,4661
200070761.0,CC Ambert Livradois Forez,339,297,347,429,198,392,2002
200070779.0,CC Brie des Rivières et Châteaux,407,326,335,398,188,272,1926
200070787.0,CC du Plateau de Lannemezan,249,201,218,273,137,248,1326
200070795.0,CC du Pays de Trie et du Magnoac,87,50,66,85,42,60,390
200070803.0,CC des Coteaux du Val-d'Arros,161,114,105,161,85,94,720
200070811.0,CC Pyrénées Vallées des Gaves,442,172,172,247,130,205,1368
200070829.0,CC Neste Barousse,93,76,75,92,67,74,477
200070845.0,CC Orne Lorraine Confluences,795,601,672,837,462,860,4227
200070852.0,CC Usses et Rhône,246,208,235,253,149,141,1232
200070894.0,CC de Gevrey-Chambertin et de Nuits-Saint-Georges,297,259,286,357,198,272,1669
200070902.0,CC Auxonne Pontailler Val de Saône,319,233,262,307,193,332,1646
200070910.0,CC Tille et Venelle,60,50,52,63,41,73,339
200070928.0,CC Terre de Picardie,301,226,282,320,212,378,1719
200070936.0,CC Ponthieu-Marquenterre,537,369,377,583,300,494,2660
200070944.0,CC du Vimeu,396,285,307,423,205,391,2007
200070951.0,CC du Territoire Nord Picardie,423,359,413,550,336,609,2690
200070969.0,CC Avre Luce Noye,286,220,242,290,180,344,1562
200070977.0,CC du Grand Roye,476,378,431,493,270,498,2546
200070985.0,CC de l'Est de la Somme,328,269,351,439,281,514,2182
200070993.0,CA de la Baie de Somme,950,663,737,935,522,893,4700
200071017.0,CC des Terres d'Auxois,192,159,166,216,112,203,1048
200071025.0,CC Haute-Provence-Pays de Banon,176,145,145,203,99,185,953
200071033.0,CC Jabron-Lure-Vançon-Durance,85,62,70,90,42,69,418
200071041.0,CC du Chaourçois et du Val d'Armance,122,101,121,163,98,162,767
200071058.0,CC Les Avant-Monts,467,363,423,527,274,444,2498
200071066.0,CA de Saint-Dié-des-Vosges,1221,931,1098,1381,803,1805,7239
200071074.0,CC Les Portes de l'Ile de France,309,261,271,332,157,284,1614
200071082.0,CA Montluçon Communauté,1114,803,895,1069,627,1278,5786
200071116.0,CA ECLA (Espace Communautaire Lons Agglomération),620,450,461,475,220,284,2510
200071140.0,CA Moulins Communauté,939,736,849,1029,587,1049,5189
200071157.0,CC des Hautes-Vosges,517,438,403,554,295,524,2731
200071165.0,CA Les Sables d'Olonne Agglomération,977,696,675,791,417,736,4292
200071173.0,CC du Pays Arnay Liernais,74,70,73,77,41,86,421
200071181.0,CC Somme Sud-Ouest,495,409,480,568,374,612,2938
200071199.0,CC Plaine Limagne,246,229,225,288,203,352,1543
200071207.0,CC de Pouilly-en-Auxois/Bligny-sur-Ouche,116,84,97,84,50,92,523
200071215.0,CC Chavanon Combrailles et Volcans,113,114,94,165,80,169,735
200071223.0,CC Nièvre et Somme,379,332,369,533,316,660,2589
200071298.0,CC des Terres du Lauragais,512,425,451,598,295,500,2781
200071314.0,CC des Hauts Tolosans,462,432,435,547,310,396,2582
200071363.0,CA Vichy Communauté,1451,1095,1128,1477,811,1669,7631
200071371.0,CC Bresse et Saône,312,268,260,292,142,223,1497
200071389.0,CC Saint-Pourçain Sioule Limagne,446,344,387,536,314,515,2542
200071405.0,CC Ardèche Rhône Coiron,410,367,400,451,267,362,2257
200071413.0,CA Privas Centre Ardèche,717,580,614,726,421,619,3677
200071454.0,CA Evreux Portes de Normandie,1971,1635,1750,2055,1119,1954,10484
200071470.0,CC Entr'Allier Besbre et Loire,307,291,244,367,213,430,1852
200071496.0,CC du Bocage Bourbonnais,175,133,147,181,128,200,964
200071504.0,CC des Collines du Perche Normand,164,126,129,170,87,158,834
200071512.0,CC Commentry Montmarault Néris Communauté,329,266,303,412,243,466,2019
200071520.0,CC Domfront Tinchebray Interco,187,190,172,192,103,186,1030
200071538.0,CC Terres de Bresse,314,245,269,367,176,292,1663
200071546.0,CC Sud Retz Atlantique,472,447,430,518,263,410,2540
200071553.0,CC Loire Layon Aubance,717,656,621,817,439,941,4191
200071579.0,CC Bresse Louhannaise Intercom',434,331,402,445,219,248,2079
200071587.0,CC Loches Sud Touraine,710,595,661,804,441,681,3892
200071595.0,"CC Arbois, Poligny, Salins, Coeur du Jura",247,189,220,280,141,198,1275
200071629.0,CC Challans-Gois Communauté,827,660,629,755,425,630,3926
200071645.0,CC Saint Cyr Mère Boitier entre Charolais et Mâconnais,92,81,103,94,53,83,506
200071652.0,CC du Pays Fertois et du Bocage Carrougien,68,45,48,54,29,47,291
200071678.0,CA du Choletais,1721,1388,1311,1553,832,1450,8255
200071751.0,CA du Bassin de Bourg-en-Bresse,2073,1567,1680,1826,938,1260,9344
200071769.0,CC Picardie des Châteaux,222,209,236,306,198,299,1470
200071777.0,"CC d'Arcis, Mailly, Ramerupt",159,137,134,215,101,185,931
200071785.0,CA Chauny-Tergnier-La Fère,1054,833,919,1087,696,1140,5729
200071819.0,CC du Périgord Nontronnais,197,160,162,164,94,139,916
200071827.0,CA du Grand Angoulême,2639,2066,2203,2617,1531,2618,13674
200071843.0,CC du Vexin Normand,509,428,457,603,280,521,2798
200071850.0,CC du Pithiverais-Gâtinais,386,296,351,453,219,383,2088
200071868.0,CC des Vallées du Haut-Anjou,528,433,437,518,274,472,2662
200071876.0,CA Saumur Val de Loire,1875,1482,1579,1996,1085,2165,10182
200071884.0,CC Le Grand Charolais,523,409,449,539,311,502,2733
200071892.0,CA du Saint-Quentinois,1713,1336,1482,1723,1036,2122,9412
200071900.0,CC Vendée Grand Littoral,655,471,413,604,315,511,2969
200071918.0,CC du Pays de Saint-Fulgent - Les Essarts,379,299,285,334,149,273,1719
200071926.0,CC du Limouxin,539,357,405,512,280,457,2550
200071934.0,CC Pays de Fontenay-Vendée,611,501,482,565,361,558,3078
200071942.0,CC Haut Limousin en Marche,269,215,242,272,145,306,1449
200071967.0,CC Pays d'Évian Vallée d'Abondance,851,508,544,646,273,314,3136
200071983.0,CC Thiérache Sambre et Oise,328,261,293,351,187,392,1812
200071991.0,CC Retz-en-Valois,460,351,431,577,333,573,2725
200072007.0,CC de la Montagne d'Ardèche,57,36,37,52,25,59,266
200072015.0,CA Annonay Rhône Agglo,796,630,671,903,462,792,4254
200072023.0,CC Coeur de Charente,265,252,268,352,192,317,1646
200072031.0,CA de la Région de Château-Thierry,1060,866,897,1026,556,936,5341
200072049.0,CC de Charente Limousine,466,366,397,520,272,486,2507
200072056.0,CC Porte du Jura,141,110,136,137,77,62,663
200072064.0,CC Val-de-Cher-Controis,682,489,543,731,394,689,3528
200072072.0,CA Territoires Vendômois,654,598,684,810,457,812,4015
200072080.0,CC du Pays de Saint-Éloy,176,154,179,233,124,186,1052
200072098.0,CC Combrailles Sioule et Morge,236,198,203,260,156,263,1316
200072106.0,CC Adour Madiran,390,254,324,396,227,278,1869
200072130.0,CA du Pays de Meaux,2024,1466,1562,1697,796,1146,8691
200072304.0,CC Vallée de l'Ubaye - Serre-Ponçon,178,120,145,149,99,135,826
200072312.0,CA Seine Normandie Agglomération,1343,1020,1102,1303,753,1312,6833
200072320.0,CC Val de Gers,139,72,86,91,48,83,519
200072346.0,CA du Pays de Fontainebleau,928,693,728,796,418,643,4206
200072452.0,CA Fougères Agglomération,836,624,650,729,368,603,3810
200072460.0,"CA de Béthune-Bruay, Artois-Lys Romane",4478,3567,3849,4782,2953,4685,24314
200072478.0,CC Pays d'Opale,353,316,322,453,247,516,2207
200072544.0,CC des Deux Morin,386,297,303,346,193,274,1799
200072635.0,CC Pyrénées Haut Garonnaises,306,170,213,251,132,210,1282
200072643.0,CC Coeur et Coteaux du Comminges,658,535,514,670,372,612,3361
200072650.0,CC Touraine Vallée de l'Indre,658,542,576,665,392,613,3446
200072668.0,CC Touraine Val de Vienne,369,263,311,398,241,372,1954
200072676.0,CC Maine Saosnois,427,361,349,447,254,414,2252
200072684.0,CC Le Gesnois Bilurien,342,333,339,421,250,394,2079
200072692.0,CC des Vallées de la Braye et de l'Anille,173,161,155,225,113,192,1019
200072700.0,CC Haute Sarthe Alpes Mancelles,313,268,243,316,185,344,1669
200072718.0,CC de la Champagne Conlinoise et du Pays de Sillé,249,195,198,282,147,293,1364
200072726.0,CC Châteaubriant-Derval,661,607,570,642,331,581,3392
200072734.0,CC Estuaire et Sillon,495,411,439,558,288,423,2614
200072825.0,CC Mirebellois et Fontenois,125,124,100,143,65,101,658
200072874.0,CC Val Briard,365,253,251,280,132,205,1486
200072882.0,CC de Vie et Boulogne,666,502,555,688,317,488,3216
200072981.0,CC Touraine Ouest Val de Loire,441,399,392,512,283,536,2563
200072999.0,CC du Grand Langres,356,271,262,265,163,214,1531
200073013.0,CC Carnelle Pays-De-France,374,250,286,291,173,233,1607
200073096.0,CA Arche Agglo,949,807,883,1055,547,938,5179
200073104.0,CC de l'Île-Rousse - Balagne,587,139,70,79,38,36,949
200073112.0,CC Sud Sarthe,338,281,302,386,219,445,1971
200073120.0,CC Nebbiu - Conca d'Oro,310,91,53,72,34,43,603
200073138.0,CC Pasquale Paoli,112,39,46,62,37,56,352
200073146.0,CC Cagire Garonne Salat,250,172,203,282,169,284,1360
200073161.0,CC Touraine-Est Vallées,493,381,401,541,269,429,2514
200073237.0,CC de Gâtine et Choisilles - Pays de Racan,294,219,201,321,163,285,1483
200073245.0,CC du Bassin d'Aubenas,899,648,699,861,491,825,4423
200073252.0,CC de la Castagniccia-Casinca,306,178,145,150,55,74,908
200073260.0,CC Sud Vendée Littoral,952,705,674,861,466,805,4463
200073344.0,CA Rambouillet Territoires,881,705,702,815,376,596,4075
200073393.0,CC des Rives du Haut-Allier,225,167,185,252,125,205,1159
200073401.0,CC Mézenc-Loire-Meygal,127,123,137,152,66,108,713
200073419.0,CA du Puy-en-Velay,1228,980,1059,1158,700,1093,6218
200073427.0,CC Marches du Velay-Rochebaron,461,371,371,474,218,375,2270
200077014.0,CA Vienne Condrieu,1528,1045,1193,1247,573,805,6391
200077055.0,CA Coulommiers Pays de Brie,1161,851,913,1008,514,733,5180
200083392.0,CA de Laval Agglomération,1873,1504,1428,1570,779,1299,8453
200084952.0,CU du Havre Seine Métropole,5056,4170,4125,5245,3041,5577,27214
200085728.0,CC de Brioude Sud Auvergne,297,211,236,264,177,270,1455
200085751.0,CC d'Entre Bièvre et Rhône,1279,898,870,1114,529,652,5342
240100610.0,CC de la Côtière à Montluel,341,311,280,272,161,184,1549
240100750.0,CA du Pays de Gex,1328,997,1132,1244,528,505,5734
240100800.0,CC de Miribel et du Plateau,342,240,275,243,123,192,1415
240100883.0,CC de la Plaine de l'Ain,1294,958,1051,1203,551,666,5723
240100891.0,CC du Pays Bellegardien (CCPB),402,294,363,360,149,236,1804
240200444.0,CC de la Thiérache du Centre,459,368,340,451,296,495,2409
240200469.0,CC du Pays de la Serre,223,185,212,292,179,376,1467
240200477.0,CA GrandSoissons Agglomération,1051,893,940,1082,657,1313,5936
240200493.0,CC du Pays du Vermandois,513,396,440,620,332,679,2980
240200501.0,CC du Val de l'Aisne,287,194,271,309,208,429,1698
240200519.0,CC du Canton d'Oulchy-le-Château,70,65,67,106,37,113,458
240200576.0,CC de la Champagne Picarde,255,210,238,348,220,439,1710
240200584.0,CC du Canton de Charly-sur-Marne,227,198,209,267,114,199,1214
240200592.0,CC du Chemin des Dames,73,66,82,110,50,95,476
240200600.0,CC des Trois Rivières,387,267,361,443,264,453,2175
240200634.0,CC des Portes de la Thiérache,105,90,93,128,68,205,689
240300491.0,CC du Pays de Lapalisse,100,92,107,127,65,145,636
240300558.0,CC du Pays de Tronçais,93,75,76,106,70,129,549
240300566.0,CC du Val de Cher,68,47,59,77,55,94,400
240300657.0,CC du Pays d'Huriel,90,72,80,132,60,110,544
240400440.0,CC Pays Forcalquier et Montagne de Lure,181,134,161,215,133,192,1016
240500439.0,CC du Briançonnais,492,328,454,473,264,381,2392
240500462.0,CC du Pays des Ecrins,128,105,137,135,64,132,701
240600551.0,CA de la Riviera Française,1652,954,893,1137,513,720,5869
240600585.0,CA de Sophia Antipolis,4171,2359,2466,3063,1460,2371,15890
240600593.0,CC du Pays des Paillons,385,307,329,328,181,242,1772
240700302.0,CC du Pays Beaume-Drobie,232,137,147,232,120,198,1066
240700617.0,CC Val de Ligne,172,109,110,127,92,138,748
240700716.0,CC du Val d'Ay,76,56,53,81,39,50,355
240700815.0,CC Berg et Coiron,148,122,131,167,85,139,792
240700864.0,CC du Rhône aux Gorges de l'Ardèche,407,298,346,396,245,376,2068
240800821.0,"CC Ardenne, Rives de Meuse",480,427,436,553,343,594,2833
240800847.0,CC des Portes du Luxembourg,270,219,242,335,214,359,1639
240800862.0,CC des Crêtes Préardennaises,272,205,215,321,155,295,1463
240800920.0,CC de l'Argonne Ardennaise,213,176,196,210,112,191,1098
240900431.0,CC du Pays de Tarascon,171,131,110,159,66,119,756
240900464.0,CC du Pays d'Olmes,312,182,246,294,183,295,1512
241000223.0,"CC Forêts, Lacs, Terres en Champagne",83,75,77,102,49,79,465
241000405.0,CC de la Région de Bar-sur-Aube,201,124,164,172,111,199,971
241000447.0,CC du Pays d'Othe,120,91,102,130,86,127,656
241000488.0,CC de l'Orvin et de l'Ardusson,104,91,101,129,81,120,626
241100593.0,CA Le Grand Narbonne,2848,2207,2272,2951,1650,2820,14748
241200187.0,CA Rodez Agglomération,803,661,695,726,391,521,3797
241200542.0,CC du Réquistanais,41,48,39,47,27,42,244
241200567.0,CC de Millau Grands Causses,563,419,435,575,308,439,2739
241200625.0,CC du Pays Rignacois,51,42,31,63,26,53,266
241200641.0,CC Conques-Marcillac,139,97,98,153,78,111,676
241200658.0,CC du Pays de Salars,78,67,64,76,49,48,382
241200674.0,CC du Plateau de Montbazens,65,54,60,62,30,33,304
241200765.0,CC de Lévézou Pareloup,45,29,30,31,38,37,210
241200807.0,CC Aveyron Bas Ségala Viaur,62,55,62,62,41,61,343
241200906.0,CC Larzac et Vallées,118,58,54,76,37,68,411
241200914.0,CC de la Muse et des Raspes du Tarn,63,62,52,67,51,47,342
241300375.0,CC Vallée des Baux-Alpilles (CC VBA),514,330,361,419,237,355,2216
241300417.0,CA d'Arles-Crau-Camargue-Montagnette,2313,1388,1578,2090,1169,1669,10207
241400415.0,CC Coeur Côte Fleurie,451,274,260,347,185,286,1803
241400514.0,CC du Pays de Falaise,444,370,359,460,288,352,2273
241400555.0,CC de Bayeux Intercom,621,334,327,437,234,341,2294
241400860.0,CC Coeur de Nacre,367,257,231,335,186,320,1696
241400878.0,CC Terre d'Auge,289,186,171,241,137,170,1194
241500230.0,CA du Bassin d'Aurillac,708,542,498,617,326,500,3191
241500255.0,CC du Pays Gentiane,66,49,43,58,26,37,279
241500271.0,CC du Pays de Mauriac,85,54,66,55,32,51,343
241501055.0,CC Sumène - Artense,104,76,77,90,43,62,452
241501089.0,CC Cère et Goul en Carladès,60,45,57,59,31,65,317
241501139.0,CC du Pays de Salers,95,57,82,76,50,54,414
241600303.0,CC du Rouillacais,128,119,117,165,101,192,822
241700434.0,CA de la Rochelle,3445,2617,2599,3077,1696,2579,16013
241700459.0,CC de l'Île de Ré,619,188,210,300,170,243,1730
241700517.0,CC Charente-Arnoult-Coeur de Saintonge,284,198,210,254,155,222,1323
241700624.0,CC de l'Île d'Oléron,843,388,287,429,196,301,2444
241700632.0,CC de Gémozac et de la Saintonge Viticole,230,198,184,259,154,243,1268
241700640.0,CA Royan Atlantique,1891,1287,1088,1491,815,1162,7734
241700699.0,CC du Bassin de Marennes,303,215,224,259,133,237,1371
241800325.0,CC Les Villages de la Forêt,52,47,57,77,40,76,349
241800374.0,CC La Septaine,155,119,105,151,63,143,736
241800424.0,CC Le Dunois,86,61,74,105,51,92,469
241800432.0,CC Les Trois Provinces,81,54,58,68,46,79,386
241800457.0,CC Fercher Pays Florentais,165,131,151,158,104,164,873
241800507.0,CA Bourges Plus,1919,1450,1426,1678,855,1740,9068
241900133.0,CC de Ventadour - Egletons - Monédières,133,118,116,125,71,112,675
241927201.0,CA Tulle Agglo,625,454,506,553,298,435,2871
241927243.0,CC du Pays d'Uzerche,108,79,74,101,63,87,512
242000354.0,CA de Bastia,1095,515,471,495,224,306,3106
242000495.0,CC de l'Alta Rocca,426,106,52,62,24,21,691
242000503.0,CC Celavu-Prunelli,194,104,88,83,52,56,577
242010056.0,CA du Pays Ajaccien,1747,871,783,913,393,515,5222
242010130.0,CC du Sartenais Valinco Taravo,643,148,101,80,31,32,1035
242020071.0,CC du Centre Corse,200,80,52,93,30,44,499
242020105.0,CC de Calvi Balagne,1079,213,99,128,48,46,1613
242100154.0,CC des Vallées de la Tille et de l'Ignon,123,132,112,166,102,172,807
242100410.0,Dijon Métropole,4796,3475,3642,4355,2192,3674,22134
242101434.0,CC du Pays Châtillonnais,242,172,237,297,196,326,1470
242101442.0,CC de Saulieu,67,51,47,76,33,70,344
242101459.0,CC du Pays d'Alésia et de la Seine,82,65,70,107,47,95,466
242101491.0,CC du Montbardois,153,127,138,157,104,151,830
242101509.0,CC Rives de Saône,277,224,203,280,151,269,1404
242200715.0,CC du Kreiz-Breizh (CCKB),249,168,238,281,181,261,1378
242400752.0,CC Périgord-Limousin,202,179,160,175,93,159,968
242400935.0,CC du Pays de Saint-Aulaye,81,71,82,124,60,102,520
242401024.0,CC Isle-Loue-Auvézère en Périgord,166,110,117,173,78,135,779
242500320.0,CC de Montbenoît,100,64,66,75,38,54,397
242500338.0,CC du Grand Pontarlier,554,365,471,451,207,307,2355
242500361.0,CA du Grand Besançon,3440,2628,2721,3152,1602,2582,16125
242504116.0,CC du Val de Morteau,369,251,285,282,127,174,1488
242504181.0,CC des Portes du Haut-Doubs,331,248,249,265,147,151,1391
242504355.0,CC du Plateau de Russey,91,61,69,79,46,50,396
242504371.0,CC du Pays de Sancey-Belleherbe,78,43,52,54,37,38,302
242504447.0,CC du Doubs Baumois,207,169,185,205,111,188,1065
242504488.0,CC Altitude 800,72,55,58,72,32,41,330
242504496.0,CC du Plateau de Frasne et du Val de Drugeon (CFD),71,60,69,57,42,41,340
242600252.0,CC du Val de Drôme,596,454,460,595,327,516,2948
242600492.0,CC Dieulefit-Bourdeaux,137,116,130,171,90,154,798
242600534.0,CC du Diois,262,196,226,311,160,252,1407
242700276.0,CC du Pays de Conches,252,198,223,280,175,345,1473
242700607.0,CC du Pays du Neubourg,272,232,259,334,182,363,1642
242700623.0,CC Eure-Madrie-Seine,467,346,371,515,247,492,2438
242852465.0,CC du Bonnevalais,136,114,148,176,93,150,817
242900074.0,CC du Pays d'Iroise,540,513,429,612,315,483,2892
242900314.0,Brest Métropole,3772,3026,2892,3453,1850,3032,18025
242900553.0,CC du Pays des Abers,489,491,430,580,302,488,2780
242900561.0,CC de Haute-Cornouaille,200,177,203,244,113,212,1149
242900629.0,CC Cap Sizun - Pointe du Raz,254,140,144,197,126,197,1058
242900645.0,CC Douarnenez Communauté,365,294,280,385,219,381,1924
242900660.0,CC du Pays Fouesnantais,431,315,322,377,197,327,1969
242900694.0,CA Quimperlé Communauté,901,632,709,913,481,772,4408
242900702.0,CC du Pays Bigouden Sud,598,431,402,563,323,481,2798
242900710.0,CC du Haut Pays Bigouden,254,217,217,275,150,235,1348
242900744.0,CC Poher communauté,237,143,166,208,130,195,1079
242900751.0,CC du Pays de Landivisiau,427,394,387,463,291,498,2460
242900769.0,CA Concarneau Cornouaille Agglomération,927,650,698,792,386,630,4083
242900793.0,CC Communauté Lesneven Côte des Légendes,388,283,334,385,208,429,2027
242900801.0,CC du Pays de Landerneau-Daoulas,652,491,537,649,393,576,3298
242900835.0,CA Morlaix Communauté,986,835,869,1066,596,991,5343
243000270.0,CC du Pays Viganais,256,159,194,233,123,203,1168
243000296.0,CC du Pays de Sommières,438,359,335,467,237,495,2331
243000569.0,"CC Rhony, Vistre, Vidourle",471,398,431,496,264,400,2460
243000585.0,CC Beaucaire Terre d'Argence,928,694,642,918,456,825,4463
243000593.0,CC de Petite Camargue,641,519,437,599,298,506,3000
243000643.0,CA de Nîmes Métropole,5494,4476,4556,5659,2931,5207,28323
243000650.0,CC Terre de Camargue,748,356,378,531,290,457,2760
243000684.0,CC du Pont du Gard,462,322,392,485,254,414,2329
243100518.0,Toulouse Métropole,18586,14287,13819,15480,7654,12123,81949
243100567.0,CC Lauragais Revel Sorezois,327,251,296,366,213,358,1811
243100633.0,CA du Sicoval,1125,907,866,1178,578,901,5555
243100732.0,CC des Coteaux du Girou,259,232,243,314,131,248,1427
243100773.0,CC de Val'Aïgo,284,246,254,268,123,232,1407
243100781.0,CC de la Save au Touch,629,496,545,582,257,451,2960
243100815.0,CC des Coteaux Bellevue,220,193,241,271,117,176,1218
243200391.0,CC de la Lomagne Gersoise,285,199,216,275,180,238,1393
243200409.0,CC du Bas Armagnac,119,81,83,118,59,108,568
243200417.0,CC de la Tenarèze,261,210,189,223,123,193,1199
243200425.0,CC Coeur d'Astarac en Gascogne,102,77,82,124,39,82,506
243200458.0,CC du Grand Armagnac,212,149,162,218,131,204,1076
243200508.0,CC Bastides et Vallons du Gers,71,89,77,115,50,79,481
243200599.0,CC du Saves,120,99,109,120,68,88,604
243200607.0,CC Artagnan de Fezensac,91,67,65,74,58,53,408
243300316.0,Bordeaux Métropole,17485,13175,12913,14686,7480,11784,77523
243300563.0,CA Bassin d'Arcachon Sud-Pôle Atlantique (COBAS),1419,853,877,1135,625,961,5870
243300811.0,CC de l'Estuaire,329,262,283,317,216,343,1750
243301165.0,CC Jalle-Eau-Bourde,334,331,311,380,174,280,1810
243301181.0,CC Latitude Nord Gironde,368,284,291,447,205,358,1953
243301215.0,CC du Créonnais,260,179,203,259,127,250,1278
243301223.0,CC du Grand Cubzaguais,684,494,512,569,347,549,3155
243301249.0,CC du Secteur de Saint-Loubès,388,331,344,401,204,338,2006
243301264.0,CC de Montesquieu,581,475,458,568,276,408,2766
243301355.0,CC des Coteaux Bordelais,280,199,223,250,133,207,1292
243301371.0,CC du Pays Foyen,318,275,231,381,194,343,1742
243301389.0,CC Médullienne,348,227,256,306,186,276,1599
243301397.0,CC du Fronsadais,247,205,217,252,139,267,1327
243301405.0,CC du Val de l'Eyre,288,241,227,340,161,276,1533
243301439.0,CC des Portes de l'Entre-deux-Mers,238,249,219,252,168,281,1407
243301447.0,CC Médoc Estuaire,396,308,349,400,198,317,1968
243301454.0,CC Castillon/Pujols,357,298,293,393,239,377,1957
243301504.0,CA du Bassin d'Arcachon Nord,1194,906,864,1069,557,853,5443
243400017.0,Montpellier Méditerranée Métropole,11677,9415,9033,10794,5464,8981,55364
243400355.0,CC du Clermontais,572,437,474,662,363,603,3111
243400470.0,CA du Pays de l'Or,1157,915,846,1106,607,911,5542
243400488.0,CC La Domitienne,587,431,471,600,293,504,2886
243400520.0,CC du Pays de Lunel,1219,987,1024,1228,661,1128,6247
243400694.0,CC Vallée de l'Hérault,719,566,621,821,473,709,3909
243400736.0,CC des Cévennes Gangeoises et Suménoises,286,200,244,343,171,261,1505
243400769.0,CA de Béziers-Méditerranée,3208,2362,2349,3023,1547,2547,15036
243400819.0,CA Hérault-Méditerranée,2451,1603,1481,2042,1187,1869,10633
243500139.0,Métropole Rennes Métropole,8374,6973,6707,7285,3763,5843,38945
243500550.0,CC Montfort Communauté,281,254,242,301,164,248,1490
243500618.0,CC de Brocéliande,233,188,188,276,138,246,1269
243500634.0,CC de la Roche aux Fées,305,303,235,332,152,298,1625
243500659.0,CC Pays de Châteaugiron Communauté,278,292,287,313,159,213,1542
243500667.0,CC du Val d'Ille-Aubigné,450,413,409,457,238,392,2359
243500725.0,CC Côte d'Émeraude,591,364,393,465,245,417,2475
243500733.0,CC Bretagne Romantique,512,427,385,525,298,477,2624
243500741.0,CA Redon Agglomération,1120,909,937,1146,538,1027,5677
243500774.0,CC Liffré-Cormier Communauté,315,266,277,277,174,207,1516
243500782.0,CA du Pays de Saint Malo Agglomération,1632,1128,1143,1328,725,1085,7041
243600202.0,CC Chabris - Pays de Bazelle,60,45,86,73,42,80,386
243600236.0,CC du Pays d'Issoudun,331,282,271,310,160,333,1687
243600293.0,CC de la Région de Levroux,79,53,49,90,57,77,405
243600301.0,CC Val de l'Indre - Brenne,195,147,162,183,87,182,956
243600319.0,CC Brenne - Val de Creuse,218,179,162,221,125,166,1071
243600327.0,CA Châteauroux Métropole,1418,1103,1081,1239,709,1265,6815
243600343.0,CC Coeur de Brenne,46,31,36,43,44,61,261
243600350.0,CC de la Châtre et Sainte-Sévère,236,156,139,233,123,226,1113
243700499.0,CC du Castelrenaudais,227,195,211,248,157,259,1297
243700754.0,Tours Métropole Val de Loire,5931,4641,4711,5406,2880,4876,28445
243700820.0,CC de Bléré Val de Cher,306,229,229,332,173,248,1517
243800604.0,CA Porte de l'Isère (C.A.P.I),2264,1493,1704,1998,968,1216,9643
243800745.0,CC de l'Oisans,193,171,286,224,121,173,1168
243800935.0,CC Lyon Saint Exupéry en Dauphiné,463,358,373,426,224,297,2141
243800984.0,CA du Pays Voironnais,1330,1052,1096,1245,656,831,6210
243801024.0,CC du Massif du Vercors,199,138,161,180,110,149,937
243801073.0,CC de Bièvre Est,273,252,258,275,149,217,1424
243801255.0,CC des Collines du Nord Dauphiné,263,210,249,303,129,167,1321
243900354.0,CC de la Station des Rousses-Haut Jura,145,94,83,90,53,73,538
243900412.0,CC Jura Sud,95,92,88,85,41,87,488
243900420.0,CC du Val d'Amour,95,82,100,129,59,77,542
243900479.0,CC du Haut-Jura - ARCADE,182,90,134,152,82,80,720
243900560.0,CC Jura Nord,133,113,122,164,72,122,726
243900610.0,CC La Grandvallière,85,65,78,68,44,40,380
243900719.0,CC du Pays des Lacs,113,65,73,80,40,55,426
243901071.0,CC de la Région d'Orgelet,66,56,68,76,29,31,326
243901089.0,CC de la Plaine Jurassienne,97,81,99,116,57,106,556
244000543.0,CC de Mimizan,289,186,168,263,173,219,1298
244000659.0,CC du Seignanx,524,410,381,510,256,357,2438
244000675.0,CA du Grand Dax,1334,800,847,1053,529,891,5454
244000691.0,CC du Pays Morcenais,170,101,128,129,92,148,768
244000766.0,CC du Pays Tarusate,277,203,214,299,152,266,1411
244000774.0,CC du Pays de Villeneuve en Armagnac Landais,81,79,69,94,49,80,452
244000808.0,CA Mont-de-Marsan Agglomération,924,722,703,796,426,647,4218
244000824.0,CC du Pays Grenadois,97,84,91,102,64,95,533
244000857.0,CC Côte Landes Nature,318,187,153,254,115,187,1214
244000865.0,CC Maremne Adour Côte Sud,2009,1196,1060,1378,688,930,7261
244000873.0,CC des Grands Lacs,758,531,472,631,346,485,3223
244000881.0,CC Coteaux et Vallées des Luys,111,57,80,94,58,90,490
244100293.0,CC des Collines du Perche,66,63,55,85,44,90,403
244100780.0,CC de la Sologne des Étangs,105,82,91,130,57,115,580
244100798.0,CC du Grand Chambord,238,159,199,244,118,265,1223
244100806.0,CC de la Sologne des Rivières,126,110,116,161,104,147,764
244200614.0,CC des Vals d'Aix et Isable,53,62,65,80,54,68,382
244200622.0,CC des Monts du Pilat,170,136,146,172,120,190,934
244200630.0,CC du Pays entre Loire et Rhône,151,120,138,164,88,129,790
244200770.0,Saint-Etienne Métropole,7960,5980,6260,7245,3983,6805,38233
244200820.0,CC du Pays d'Urfé,71,45,54,58,38,57,323
244200895.0,CC du Pilat Rhodanien,198,154,181,267,147,210,1157
244300307.0,CC du Pays de Montfaucon,108,75,95,118,59,81,536
244301016.0,CC des Sucs,243,199,215,223,152,207,1239
244301099.0,CC Auzon Communauté,119,112,131,155,111,160,788
244301107.0,CC du Haut-Lignon,129,82,94,87,47,87,526
244301123.0,CC des Pays de Cayres et de Pradelles,71,40,50,58,28,61,308
244301131.0,CC Loire et Semène,254,229,253,298,138,227,1399
244400404.0,Nantes Métropole,12730,10274,10152,11516,6140,9926,60738
244400438.0,CC de Grand Lieu,525,451,440,556,285,389,2646
244400453.0,CC de la Région de Blain,259,168,200,220,109,211,1167
244400503.0,CC d'Erdre et Gesvres,795,679,648,800,383,622,3927
244400537.0,CC de Nozay,205,186,175,197,128,194,1085
244400552.0,CC du Pays d'Ancenis,1000,827,821,986,519,847,5000
244400586.0,CC du Sud-Estuaire,499,377,369,485,267,415,2412
244400610.0,CA de la Presqu'île de Guérande Atlantique (Cap Atlantique),1556,969,796,1095,546,957,5919
244400644.0,CA de la Région Nazairienne et de l'Estuaire (CARENE),2644,1932,1907,2333,1279,2115,12210
244500203.0,CA Montargoise et Rives du Loing (A.M.E.),1372,1082,1140,1295,708,1307,6904
244500211.0,CC Giennoises,491,346,359,467,247,461,2371
244500419.0,CC des Quatre Vallées,224,196,219,254,138,242,1273
244500427.0,CC des Loges,497,438,450,546,269,503,2703
244500468.0,Orléans Métropole,5669,4187,4560,5216,2642,4645,26919
244500484.0,CC de la Forêt,183,138,169,207,110,194,1001
244500542.0,CC de la Plaine du Nord Loiret,87,71,95,97,50,69,469
244600433.0,CC de la Vallée du Lot et du Vignoble,199,190,197,238,128,228,1180
244600482.0,CC Quercy - Bouriane,167,136,141,153,85,150,832
244600532.0,CC du Pays de Lalbenque-Limogne,158,86,95,132,83,125,679
244600573.0,CC du Causse de Labastide-Murat,58,30,41,51,31,49,260
244700449.0,CC du Pays de Duras,65,60,69,90,53,88,425
244700464.0,CC du Pays de Lauzun,149,90,113,154,89,141,736
244701355.0,CC des Coteaux et Landes de Gascogne,207,145,143,202,130,180,1007
244701405.0,CC Lot et Tolzac,130,90,72,127,86,114,619
244800405.0,CC Coeur de Lozère,245,156,139,196,79,111,926
244800470.0,CC du Gévaudan,92,84,102,116,47,94,535
244900015.0,CU Angers Loire Métropole,5953,5144,4927,5835,3334,5823,31016
244900809.0,CC Anjou Bleu Communauté,618,462,448,550,304,466,2848
244900882.0,CC Baugeois Vallée,548,421,446,602,330,655,3002
245100615.0,CC de la Grande Vallée de la Marne,144,126,151,167,112,178,878
245100888.0,CC de la Brie Champenoise,103,74,78,107,55,83,500
245100979.0,CC du Sud Marnais,97,77,71,125,61,120,551
245200597.0,CC des Trois Forêts,75,79,82,71,31,71,409
245300223.0,CC du Pays de Meslay-Grez,185,163,153,161,100,139,901
245300355.0,CC de l'Ernée,230,177,179,198,109,174,1067
245300389.0,CC du Bocage Mayennais,210,152,137,168,93,187,947
245300447.0,CC du Pays de Château-Gontier,413,340,331,409,236,382,2111
245400171.0,CC Moselle et Madon,321,300,257,314,203,293,1688
245400189.0,CC des Pays du Sel et du Vermois,332,258,292,395,212,430,1919
245400262.0,CA de Longwy,880,670,835,864,469,847,4565
245400510.0,CC du Pays de Colombey et du Sud Toulois,138,95,89,144,60,108,634
245400601.0,CC du Bassin de Pompey,481,419,469,555,324,628,2876
245400676.0,Métropole du Grand Nancy,4481,3508,3386,3860,2082,3930,21247
245400759.0,CC du Pays du Sanon,54,45,47,83,36,57,322
245500327.0,CC du Sammiellois,107,99,136,133,87,167,729
245501176.0,CC du Territoire de Fresnes-en-Woëvre,62,45,60,63,33,62,325
245501184.0,CC du Pays de Revigny-sur-Ornain,95,61,79,105,54,101,495
245501242.0,CC du Pays d'Étain,122,76,90,123,62,124,597
245501259.0,CC du Pays de Montmédy,81,60,67,67,50,85,410
245600440.0,CC de Blavet Bellevue Océan,233,182,178,233,128,223,1177
245600465.0,CC de Belle-Île-en-Mer,185,88,68,118,49,88,596
245614383.0,CC Questembert Communauté,374,283,290,351,177,332,1807
245614417.0,CC Roi Morvan Communauté,383,263,287,398,213,437,1981
245614433.0,CC Pontivy Communauté,675,561,572,689,346,574,3417
245700133.0,CC du District Urbain de Faulquemont (DUF),354,282,287,339,183,286,1731
245700372.0,CA de Forbach Porte de France,1437,1174,1203,1361,772,1404,7351
245700398.0,CC de Freyming-Merlebach,710,471,544,597,357,561,3240
245700695.0,CC de Cattenom et Environs,234,201,217,220,135,155,1162
245700950.0,CC du Pays de Phalsbourg,234,167,151,195,116,148,1011
245701164.0,CC du Warndt,332,236,293,323,206,358,1748
245701206.0,CC du Saulnois,398,276,306,333,179,276,1768
245701222.0,CA du Val de Fensch,1319,985,1048,1314,682,1144,6492
245701271.0,CC du Pays Orne Moselle,846,727,766,928,534,886,4687
245701354.0,CC de l'Arc Mosellan,363,281,344,375,199,327,1889
245701362.0,CA Portes de France-Thionville,1364,991,1032,1133,637,966,6123
245701404.0,CC du Pays Haut Val d'Alzette,367,264,288,347,177,333,1776
245801063.0,CC Loire et Allier,68,55,61,79,34,42,339
245804406.0,CA de Nevers,1053,757,773,865,463,665,4576
245804497.0,CC du Nivernais Bourbonnais,69,54,45,66,45,58,337
245900410.0,Métropole Européenne de Lille,22897,17573,17832,20964,12199,21144,112609
245900428.0,CU de Dunkerque,3987,3143,3189,3950,2485,4082,20836
245900758.0,CC Flandre Lys,532,454,430,589,320,480,2805
245901038.0,CC du Pays Solesmois,219,164,205,262,168,296,1314
245901061.0,CC de la Haute-Deûle,268,253,238,335,216,358,1668
245901152.0,CC Coeur d'Ostrevent,1357,1061,1141,1655,1001,1607,7822
245901160.0,CA Valenciennes Métropole,3951,3232,3368,4076,2536,3979,21142
246000129.0,CC du Liancourtois,338,245,289,332,201,283,1688
246000376.0,CC du Clermontois,513,442,445,501,264,440,2605
246000566.0,CC du Plateau Picard,424,355,404,487,257,360,2287
246000582.0,CC des Sablons,657,519,544,576,323,493,3112
246000707.0,CC du Vexin-Thelle,247,237,234,249,128,208,1303
246000749.0,CC des Lisières de l'Oise,202,192,177,247,133,253,1204
246000756.0,CC du Pays Noyonnais,661,508,543,606,359,639,3316
246000764.0,CC de l'Aire Cantilienne,527,439,457,496,265,355,2539
246000772.0,CC des Deux Vallées,368,277,303,369,191,394,1902
246000848.0,CC de la Picardie Verte,455,376,451,543,303,522,2650
246000855.0,CC du Pays des Sources,293,212,276,325,178,274,1558
246000871.0,CC du Pays de Valois,785,614,657,754,392,655,3857
246000897.0,CC de la Plaine d'Estrées,207,162,186,191,135,227,1108
246000913.0,CC du Pays de Bray,260,200,235,285,172,296,1448
246000921.0,CC des Pays d'Oise et d'Halatte,519,401,414,545,286,463,2628
246100390.0,CC du Val d'Orne,57,55,62,76,52,80,382
246100663.0,CU d'Alençon,1011,755,741,822,405,650,4384
246200299.0,CA d'Hénin-Carvin,2349,1889,2068,2578,1670,2752,13306
246200364.0,CA de Lens - Liévin,4536,3576,4027,4878,2934,4776,24727
246200380.0,CC de la Terre des Deux Caps,327,259,259,297,224,372,1738
246200729.0,CA du Boulonnais,2313,1759,1863,2413,1326,2334,12008
246200844.0,CC de la Région d'Audruicq,334,320,338,483,267,417,2159
246201016.0,CC du Pays de Lumbres,264,232,270,331,229,349,1675
246201149.0,CA du Calaisis,1968,1566,1837,2241,1341,2486,11439
246300701.0,Clermont Auvergne Métropole,4811,3990,4014,4620,2653,4428,24516
246300966.0,CC du Massif du Sancy,185,139,116,203,106,190,939
246301097.0,CC Entre Dore et Allier,255,224,217,297,168,303,1464
246400337.0,CC de la Vallée d'Ossau,147,119,122,124,80,136,728
246401756.0,CC Pays de Nay,373,327,285,366,199,315,1865
246500482.0,CC de la Haute-Bigorre,269,186,204,304,175,327,1465
246500573.0,CC Aure-Louron,135,83,134,168,71,137,728
246600282.0,CC Sud-Roussillon,572,447,436,574,312,588,2929
246600373.0,CC du Vallespir,487,341,349,508,252,422,2359
246600399.0,CC Pyrénées Cerdagne,164,102,105,176,82,113,742
246600415.0,CC Roussillon-Conflent,393,384,315,474,276,459,2301
246600423.0,CC Agly Fenouillèdes,105,72,99,133,60,165,634
246600449.0,CC des Aspres,470,421,316,499,287,466,2459
246600464.0,CC Pyrénées catalanes,105,97,125,148,82,130,687
246600548.0,CC du Haut Vallespir,239,140,184,259,119,202,1143
246700306.0,CC de la Vallée de la Bruche,261,201,247,262,174,285,1430
246700488.0,Eurométropole de Strasbourg,9768,7550,7878,8900,4608,8345,47049
246700744.0,CC des Portes de Rosheim,219,155,152,184,102,191,1003
246700777.0,CC de la Vallée de Villé,120,94,105,116,60,104,599
246700843.0,CC de la Basse-Zorn,193,136,185,167,81,151,913
246700926.0,CC du Pays de Wissembourg,246,115,158,188,103,206,1016
246700959.0,CC du Pays de la Zorn,141,124,126,134,88,114,727
246700967.0,CC de Sélestat,657,444,507,529,301,494,2932
246701064.0,CC de la Région de Molsheim-Mutzig,470,381,409,520,287,383,2450
246701080.0,CC du Pays de Sainte-Odile,264,198,237,274,131,248,1352
246701098.0,CC du Pays de Niederbronn-les-Bains,299,220,257,344,157,291,1568
246800205.0,CC de la Vallée de Saint-Amarin,188,107,129,182,96,150,852
246800395.0,CC du Val d'Argent,138,130,126,130,85,141,750
246800445.0,CC du Centre du Haut-Rhin,169,150,184,216,114,149,982
246800494.0,"CC du Pays de Rouffach, Vignobles et Châteaux",133,104,118,144,55,106,660
246800551.0,CC de la Vallée de Kaysersberg,193,142,166,197,104,167,969
246800569.0,CC de la Région de Guebwiller,537,452,528,622,328,491,2958
246800577.0,CC du Pays de Ribeauvillé,220,152,173,184,104,167,1000
246800585.0,CC de la Vallée de Munster,217,125,160,186,105,171,964
246800676.0,CC de la Vallée de la Doller et du Soultzbach,230,152,157,196,109,156,1000
246800726.0,CA Colmar Agglomération,1881,1470,1459,1688,903,1570,8971
246900575.0,CC de l'Est Lyonnais (CCEL),435,343,377,440,216,311,2122
246900625.0,CC du Pays de l'Arbresle (CCPA),442,387,410,483,226,374,2322
246900724.0,CC des Vallons du Lyonnais (CCVL),310,294,251,326,159,224,1564
246900740.0,CC du Pays Mornantais (COPAMO),281,242,245,306,151,220,1445
246900757.0,CC de la Vallée du Garon (CCVG),358,307,351,393,170,222,1801
246900765.0,CC du Pays de l'Ozon,292,233,259,295,128,198,1405
247000011.0,CA de Vesoul,584,441,436,506,251,381,2599
247000367.0,CC des Combes,107,77,88,89,43,61,465
247000623.0,CC des Quatre Rivières,130,109,107,108,66,94,614
247000664.0,CC du Pays de Lure,322,281,280,320,149,295,1647
247000698.0,CC des Monts de Gy,95,69,61,92,40,73,430
247000706.0,CC du Pays Riolais,152,120,135,145,80,100,732
247000714.0,CC du Pays de Villersexel,122,59,81,116,60,97,535
247000722.0,CC du Pays d'Héricourt,348,265,254,349,190,277,1683
247000755.0,CC du Pays de Luxeuil,264,191,232,252,125,213,1277
247000821.0,CC Rahin et Chérimont,151,127,149,190,104,175,896
247000854.0,CC des 1000 étangs,104,92,99,137,81,135,648
247100290.0,CU Le Creusot Montceau-les-Mines,1506,1105,1384,1568,838,1567,7968
247100589.0,CA Le Grand Chalon,1948,1404,1562,1997,1017,1802,9730
247100639.0,CC de Marcigny,64,68,55,71,43,75,376
247100647.0,CC Bresse Nord Intercom,87,66,75,75,52,73,428
247103765.0,CC Entre Saône et Grosne,146,96,130,168,97,163,800
247103864.0,CC du Canton de Semur-en-Brionnais,57,37,52,62,36,66,310
247104094.0,CC Sud Côte Chalonnaise,131,104,112,151,94,152,744
247200090.0,CC de Sablé-sur-Sarthe,555,444,412,468,288,456,2623
247200132.0,CU Le Mans Métropole,4816,3695,3573,4255,2329,4157,22825
247200348.0,CC du Pays Fléchois,425,367,330,454,286,456,2318
247200421.0,CC du Sud Est du Pays Manceau,202,160,153,197,105,198,1015
247200447.0,CC Orée de Bercé - Belinois,229,217,199,247,139,282,1313
247200629.0,CC du Val de Sarthe,373,309,320,393,249,434,2078
247200686.0,CC du Pays de l'Huisne Sarthoise,398,367,395,471,263,410,2304
247300015.0,CC des Vallées d'Aigueblanche,158,57,99,71,21,26,432
247300254.0,CC de Haute-Tarentaise,307,180,308,218,87,83,1183
247300262.0,CC de Yenne,115,66,73,102,54,78,488
247300361.0,CC du Canton de la Chambre,107,84,84,75,39,63,452
247300452.0,CC Maurienne Galibier,85,51,54,54,28,29,301
247300528.0,CC Val Guiers,190,144,153,159,114,119,879
247300668.0,CC du Lac d'Aiguebelette (CCLA),84,54,64,70,44,52,368
247300676.0,CC Porte de Maurienne,101,52,78,64,43,52,390
247300817.0,CC Les Versants d'Aime,158,108,188,110,53,42,659
247400047.0,CC de la Vallée Verte,91,89,96,121,47,53,497
247400112.0,CC du Pays de Cruseilles,201,145,199,165,93,74,877
247400567.0,CC Fier et Usses,200,164,182,198,94,114,952
247400583.0,CC Arve et Salève,272,212,254,265,123,113,1239
247400617.0,CC des Vallées de Thônes,261,198,214,242,80,136,1131
247400666.0,CC des Quatre Rivières,289,216,211,238,128,119,1201
247400682.0,CC du Haut-Chablais,176,146,178,203,102,119,924
247400690.0,CC du Genevois,784,593,641,649,268,239,3174
247400724.0,CC du Pays Rochois,435,307,298,352,170,168,1730
247400740.0,CC Rumilly Terre de Savoie,476,315,352,413,177,238,1971
247400773.0,CC des Sources du Lac d'Annecy,258,181,196,229,104,130,1098
247600505.0,CC Campagne-de-Caux,172,131,131,182,120,205,941
247600588.0,CC des Villes Soeurs,634,464,523,631,395,771,3418
247600604.0,CC de Londinières,58,50,66,82,46,86,388
247600620.0,CC Yvetot Normandie,336,302,304,406,212,413,1973
247600646.0,CC Caux - Austreberthe,380,275,333,436,188,391,2003
247600729.0,CC Falaises du Talou,300,262,302,418,249,420,1951
247600786.0,CA de la Région Dieppoise,910,704,726,944,615,1053,4952
247700032.0,CC Moret Seine et Loing,500,384,411,494,271,405,2465
247700057.0,CA Melun Val de Seine,2935,2002,2098,2311,1092,1548,11986
247700065.0,CC du Pays de l'Ourcq,266,230,228,294,136,209,1363
247700107.0,CC Pays de Montereau,901,666,682,816,378,539,3982
247700339.0,CA Val d'Europe Agglomération,546,422,428,419,238,311,2364
247700438.0,CC Pays Créçois,436,312,329,373,185,305,1940
247700594.0,CA Marne et Gondoire,1666,1289,1213,1401,723,951,7243
247700644.0,CC l'Orée de la Brie,355,311,299,333,160,184,1642
247700701.0,CC Brie Nangissienne,409,321,354,372,198,236,1890
247800550.0,CC du Pays Houdanais (C.C.P.H.),333,244,235,318,156,226,1512
247800584.0,CA Versailles Grand Parc (C.A.V.G.P.),2986,2294,2318,2498,1229,1924,13249
247800618.0,CC Coeur d'Yvelines,493,393,377,456,232,334,2285
247900798.0,CC du Thouarsais,592,447,467,577,305,476,2864
248000499.0,CC du Val de Somme,324,285,293,396,202,440,1940
248000531.0,CA Amiens Métropole,3743,2735,2898,3569,2041,3612,18598
248000747.0,CC du Pays du Coquelicot,417,368,415,490,253,527,2470
248100158.0,CC du Sor et de l'Agout,335,248,283,351,195,281,1693
248100430.0,CA de Castres Mazamet,1466,1096,1135,1441,772,1209,7119
248100497.0,CC Val 81,63,47,54,66,33,64,327
248100737.0,CA de l'Albigeois (C2A),1536,1143,1132,1413,730,1095,7049
248100745.0,CC Thoré Montagne Noire,70,58,50,88,56,58,380
248200016.0,CC des Deux Rives,365,237,262,388,196,299,1747
248200057.0,CC du Quercy Caussadais,388,278,323,401,221,354,1965
248200065.0,CC de la Lomagne Tarn-et-Garonnaise,153,124,153,169,81,115,795
248200099.0,CA Grand Montauban,1644,1303,1285,1637,826,1318,8013
248200107.0,CC du Quercy Rouergue et des Gorges de l'Aveyron,133,87,107,146,93,137,703
248300394.0,CA Sud Sainte-Baume,1133,744,723,921,490,702,4713
248300410.0,CC de la Vallée du Gapeau,506,370,320,403,208,278,2085
248300493.0,CA Dracénoise,2230,1686,1610,1967,903,1464,9860
248300543.0,Métropole Toulon-Provence-Méditerranée,8716,5947,5719,6927,3666,5793,36768
248300550.0,CC Coeur du Var,807,663,610,776,382,575,3813
248400053.0,CA Ventoux-Comtat-Venaissin (COVE),1646,1185,1302,1507,799,1361,7800
248400160.0,CC Aygues-Ouvèze en Provence (CCAOP),343,255,298,332,194,264,1686
248400236.0,CC du Pays Réuni d'Orange,1025,799,810,1018,537,840,5029
248400251.0,CA du Grand Avignon (COGA),4666,3475,3742,4455,2312,3564,22214
248400285.0,CC Territoriale Sud-Luberon,420,343,378,456,225,359,2181
248400293.0,CC des Sorgues du Comtat,1065,776,837,1079,575,880,5212
248400319.0,CC du Pays des Sorgues et des Monts de Vaucluse,674,447,524,658,358,584,3245
248400335.0,CC Vaison Ventoux,325,235,240,287,172,274,1533
248500191.0,CC de l'Île de Noirmoutier,257,118,104,153,96,125,853
248500258.0,CC Océan Marais de Monts,450,344,292,370,182,317,1955
248500340.0,CC Pays de Chantonnay,323,268,302,376,164,282,1715
248500415.0,CC du Pays de la Châtaigneraie,229,160,192,164,120,183,1048
248500464.0,CC du Pays de Pouzauges,359,266,263,341,183,247,1659
248500530.0,CC du Pays des Achards,322,251,243,304,161,269,1550
248500563.0,"CC Vendée, Sèvre, Autise",255,192,193,248,125,229,1242
248500589.0,CA La Roche-sur-Yon Agglomération,1802,1495,1434,1680,853,1453,8717
248500621.0,CC du Pays des Herbiers,496,395,384,442,211,331,2259
248500662.0,CC du Pays de Mortagne,371,283,306,327,169,265,1721
248600413.0,CA Grand Châtellerault,1283,1112,1066,1358,743,1147,6709
248600447.0,CC du Pays Loudunais,382,293,331,416,237,430,2089
248700189.0,CC du Pays de Saint-Yrieix,148,142,141,169,90,132,822
248719262.0,CC Gartempe - Saint-Pardoux,47,48,51,59,38,78,321
248719288.0,CC du Val de Vienne,154,123,158,184,100,122,841
248719312.0,CU Limoges Métropole,3447,2738,2715,3196,1622,2835,16553
248719338.0,CC Briance-Combade,52,54,55,48,42,79,330
248719353.0,CC des Portes de Vassivière,75,46,58,85,43,77,384
248719361.0,CC de Noblat,143,119,106,162,93,154,777
248900334.0,CA du Grand Sénonais,1105,854,950,1081,545,810,5345
248900383.0,CC de l'Agglomération Migennoise,245,196,246,268,161,212,1328
248900524.0,CC de l'Aillantais,122,86,140,168,59,111,686
248900664.0,CC de la Vanne et du Pays d'Othe,119,101,105,157,67,110,659
248900748.0,CC du Gâtinais en Bourgogne,233,186,212,254,125,194,1204
248900896.0,CC Yonne Nord,331,309,296,343,158,263,1700
248900938.0,CC du Jovinien,365,258,313,362,205,288,1791
249000241.0,CC du Sud Territoire,420,324,393,395,214,322,2068
249100074.0,CC du Pays de Limours (CCPL),219,167,181,181,91,142,981
249100157.0,CC des Deux Vallées,179,147,164,184,98,117,889
249100546.0,CC du Val d'Essonne (CCVE),698,497,551,583,279,414,3022
249100553.0,CC Entre Juine et Renarde (CCEJR),308,191,233,287,114,199,1332
249100595.0,CC Le Dourdannais en Hurepoix (CCDH),337,236,254,281,129,189,1426
249500109.0,CA de Cergy-Pontoise,4381,3164,3165,3580,1785,2592,18667
249500430.0,CC Sausseron Impressionnistes,199,162,178,172,90,171,972
249500455.0,CC de la Vallée de l'Oise et des Trois Forêts,440,354,377,426,214,330,2141
249500489.0,CC du Haut Val d'Oise,725,542,592,601,285,385,3130
249500513.0,CC du Vexin-Val de Seine,221,163,152,200,129,185,1050
249710047.0,CC de Marie-Galante,223,226,209,298,180,327,1463
249710062.0,CA du Nord Basse-Terre,1664,1509,1601,2070,1173,2906,10923
249710070.0,CA Grand Sud Caraïbe,1679,1556,1553,2268,1501,4195,12752
249720053.0,CA de l'Espace Sud de la Martinique,2492,2137,2549,3014,1823,3701,15716
249720061.0,CA du Centre de la Martinique,3276,2975,3165,3807,2017,4775,20015
249730037.0,CC de l'Ouest Guyanais,1364,1014,991,1029,458,602,5458
249730045.0,CA du Centre Littoral,3595,2925,2507,2405,1009,1424,13865
249730052.0,CC de l'Est Guyanais,176,140,118,128,56,113,731
249740077.0,CA CIVIS (Communauté Intercommunale des VIlles Solidaires),4750,4332,4837,7094,4797,11157,36967
249740085.0,CA du Sud,3293,2972,3718,4984,3415,8137,26519
249740093.0,CA Intercommunale de la Réunion Est (CIREST),3323,2749,3313,4311,2578,5363,21637
249740101.0,CA Territoire de la Côte Ouest (TCO),5506,5250,6293,7823,4809,11828,41509
249740119.0,CA Intercommunale du Nord de la Réunion (CINOR),5143,4726,4976,7063,4375,8121,34404
,Hors EPCI,1340,822,782,813,383,1382,5522
